Kaugummi|Mund-Z#ae#hne-Essen-Blase-Pfefferminz
Luftschiff|fliegen-Fahrzeug-Ballon-Werbung-Zeppelin
Explosion|sprengen-Dynamit-fliegen-Luft-Feuer
U-Bahn|Tunnel-Zug-fahren-Verkehr-#oe#ffentlich
Schaltjahr|366-4-29-Februar-Tag
Kreuzfahrt|Urlaub-Schiff-Luxus-Ziel-Karibik
Kater|Katze-Tier-m#ae#nnlich-Kopfweh-Morgen
Hubschrauber|fliegen-Rotor-Motor-drehen-senkrecht
Dicksch#ae#del|stur-Eigensinn-Kopf-d#ue#nn-nachgeben
K#oe#nig|Monarch-Herrscher-Land-Krone-Kaiser
Steinzeit|Geschichte-Epoche-Jahr-H#oe#hle-Mensch
Scharchen|schlafen-Nase-schnaufen-Ger#ae#usch
Patient|Arzt-Doktor-krank-behandeln-pflegen
Mumie|Leiche-K#oe#rper-tot-einbalsamieren-Grab-#ae#gypten
Neugier|Interesse-erfahren-fliegen-fragen-herausfinden-spannend
Festhalten|Hand-Griff-verlieren-fallen-umarmen
K#ae#mmen|Haare-B#ue#rste-ordnen-Finger-Kopf
Kuss|Mund-Lippen-Wange-Liebe-knutschen-Paar
Stress|#ae#rger-Arbeiten-viel-anstrengend-Nerven
Windpocken|krank-Kind-anstecken-Pusteln-Virus
Nadel|n#ae#hen-Faden-stecken-spitzen-Heuhaufen
Rest|#ue#brig-wenig-Ende-Essen-M#ue#ll
Wanderpokal|Troph#ae#e-Preis-gewinnen-laufen-gehen
Ehrlichkeit|Warheit-l#ue#gen-sagen-Vertrauen-aufrichtig
Nagel|Hammer-Wand-schlagen-Finger-Zeh
H#ae#ngematte|Netz-Bett-schlafen-anbinden-Baum
Weinregal|Flasche-Holz-Lager-liegen-sammeln
Cookie|Internet-Website-Daten-speichern-Keks
Pantoffelheld|Mann-Ehe-Frau-Schuh-darunter
Spinne|Netz-acht-Beine-Insekt-krabbeln
Lasso|Seil-Cowboy-werfen-Schlinge-Kuh
Fr#ue#hbucher|Urlaub-Ferien-Hotel-Prozente-Rabatt
S#ae#ule|Geb#ae#ude-St#ue#tze-halten-Decke-Boden
Taucherbrille|Wasser-schwimmen-unten-Schutz-Auge
Extremsport|Freizeit-besonders-Kick-aufregend-ungew#oe#hnlich
Eidechse|Reptil-Tier-klein-hei#ss#-Schwanz
Kugelfisch|Wasser-Tier-Japan-rund-giftig
Paparazzi|Fotograf-Journalist-Presse-heimlich-jagen
Lachen|kichern-Hahaha-Witz-lustig-Spa#ss#
Job|Beruf-Stelle-Geld-arbeiten-Gehalt-Steuern
Neon|Licht-grell-R#oe#hre-Farbe-Element
Note|Musik-spielen-Sch#ue#ssel-Duft-Schule
Birne|Obst-Baum-essen-gl#ue#hen-Kopf
Loch|bohren-L#ue#cke-Nase-Ohr-Ness
Ohrring|Schmuck-Kopf-zwei-Loch-Piercing
Lebkuchen|Geb#ae#ck-essen-Weihnachten-Mann-Haus
Sattel|Pferd-reiten-Fahrrad-sitzen-Leder
Fallschirm|fliegen-springen-Flugzeug-Rei#ss#leine-#oe#ffnen
Slum|Stadt-Viertel-arm-leben-Elend
Gitarre|Musik-Instrument-spielen-Saiten-Bass-stimmen
Schneebesen|Winter-Eis-K#ue#che-r#ue#hren-kehren-backen
Dudelsack|Musik-Instrument-Pfeifen-blasen-Schottland
Boxer|Sport-Kampf-Ring-Handschuhe-Hund
Mais|Feld-Korn-gelb-essen-Kolben
Brillenschlange|Auge-sehen-Glas-Reptil-lang
Inlineskates|Rollschuh-laufen-fahren-Reihe-Blades
Restauranttester|Fernsehen-Reality-Gastst#ae#tte-pr#ue#fen-Michelin
** LOL **|eMail-SMS-Zeichen-lachen-Smiley
Borinsel|#oe#l-Plattform-Meer-See-Sockel
Irrgarten|Labyrinth-Weg-laufen-Ausgang-finden
Fast Food|Hamburger-Cheeseburger-Pommes-D#oe#ner-Bratwurst
K#ae#nguru|Tier-Beutel-springen-Australien-boxen
Globus|Welt-Kugel-rund-drehen-Atlas
Bumerang|werfen-krumm-zur#ue#ck-Luft-Australien
Parf#ue#m|Duft-Geruch-Flakon-spr#ue#hen-gut
Anruf|Telefon-Handy-klingeln-Freund-rangehen
Kalender|Monat-Jahr-Tag-Zeit-Zahl
Tr#ue#ffel|Pilz-schwarz-Schwein-Schokolade-Praline
Trauzeuge|Hochzeit-Braut-Ehe-Ring-zwei
Jeans|Hose-Bein-blau-Stoff
Rassel|Baby-spielen-sch#ue#tteln-Ger#ae#usch-klappern
Kupfer|Ketall-M#ue#nze-rot-Gold-Kessel
Erdm#ae#nnchen|Tier-klein-W#ue#ste-stehen-gucken
Rippen|K#oe#rper-Wirbel-Knochen-Brust-Schutz
Valentinstag|Februar-14-Liebe-Blumen-Karte
Lampenfieber|B#ue#hne-Auftritt-vorher-nerv#oe#s-aufgeregt
Luftkissenboot|F#ae#hre-Wasser-schweben-Propeller-Hovercraft-schlafen-Bett
Pfandhaus|Schmuck-Wert-verleihen-Geld-versetzen
K#ue#hlschrank|K#ue#che-Ger#ae#t-Eis-kalt-Essen
Verstecken|weg-heimlich-Spiel-suchen-finden
Strohhalm|trinken-lang-Glas-Heu-klammern
Streichholz|Feuer-brennen-anz#ue#nden-reiben-Schachtel
Drau#ss#en|drinnen-Natur-Haus-frei-Ausflug
Sch#ue#chtern|scheu-zur#ue#ckhalten-Scham-Angst-verlegen
Mayonnaise|Sauce-Ei-#oe#l-Salat-Ketchup-wei√ü-Pommes
Hering|Fisch-Meer-Schwarm-Dose-ger#ae#uchert
Quartett|vier-Karten-sammeln-Instrument-Musik
R#ue#ssel|Nase-lang-Elefant-Schwein-saugen
Boxenstopp|Formel 1-Auto-rennen-Reifen-tanken
M#ue#ll|Abfall-Tonne-T#ue#te-wegwerfen-rausbringen
Jacht|Boot-Schiff-Meer-Segel-reich
Forum|Platz-Ort-Internet-treffen-diskutieren
Spion|Agent-geheim-Informationen-verdeckt-James Bond
Glatteis|Winter-frieren-Wasser-rutschen-f#ue#hren
Nickerchen|schlafen-m#ue#de-Mittag-kurz-Sofa
Joggen|laufen-rennen-Sport-fit-Ausdauer
Tennisarm|Sport-Netz-Ball-Schl#ae#ger-wehtun
Ap#ue#theke|Rezept-Arzt-Medikament-Tablette-kaufen
Bluetooth|Funk-#ue#bertragung-Verbindung-Handy-Computer
Talent|Begabung-k#oe#nnen-besonders-zeigen-Show
Kunde|kaufen-Gesch#ae#ft-schoppen-Geld-Klient
Kritiker|Zeitung-Bericht-beurteilen-Film-Buch
Kloster|Nonne-M#oe#nch-Orden-Religion-leben
Taube|Vogel-gurren-Stadt-Frieden-Liebe
Diamant|Stein-Brillant-Schmuck-Ring-hart
Papier|schreiben-Stift-Blatt-wei#ss#-Buch
Polterabend|Hochzeit-Tag-davor-Teller-schmei#ss#en
Pferdeschwanz|Zopf-Haare-lang-Gummi-Frisur
Bach|Wasser-Fluss-klein-pl#ae#tschern-Bl#ue#ten
Gehirnw#ae#sche|denken-Verstand-Kopf-neu-s#ae#ubern
Himmelbett|ohne-Sonne-Wolke-schlafen-Dach
Looping|Schleife-#ue#berschlag-fliegen-Achterbahn-kopf#ue#ber
Waage|Gewicht-Gramm-Kilo-K#ue#che-Sternzeichen
Scanner|Computer-erkennen-Kasse-Piep|-Bild
Schaumparty|Disco-tanzen-Leute-Kanone-wei#ss#
Slacklining|Seil-Gurt-balancieren-Baum-spannen
Big Bang|Theory-Urknall-Comedy-Sheldon-Leonard
Touchscreen|Computer-Tablet-Finger-Monitor-ber#ue#hren
Anstubsen|Finger-sto#ss#en-klopfen-Freund-Facebook
Saftladen|Gesch#ae#ft-schlecht-bl#oe#d-Orange-trinken
Federbett|Decke-schlafen-warm-kissen-Gans
Rasierapparat|Bart-Kinn-Morgen-brummen
Freiheitsstatue|New York-Amerika-Symbol-Fackel-Insel
Dschungelcamp|Star-holt-mich-hier-raus|
Bommel|Wolle-M#ue#tze-baumeln-rund-Kugel
Olympische Ringe|Sport-Spiele-Flagge-Farben-f#ue#nf
Banane|Obst-gelb-krumm-Schale-ausrutschen
Quiz|Frage-Antwort-Spiel-raten-gewinnen
Kummertante|Sorgen-Problem-Brief-Zeitschrift-Telefon
Weisheitszahn|Gebiss-Mund-Arzt-Ziehen
Elfenbein|Elefant-Zahn-wei#ss#-Afrika-K#ue#ste
Hypothek|Haus-Bank-Geld-Raten-abzahlen
Tablet|Computer-PC-klein-ber#ue#hren-Finger
Landkarte|Plan-Stra#ss#e-Ort-Atlas-suchen
Zocken|spielen-Finger-dr#ue#cken-Punkte-Computer
Reality-Show|Fernsehen-Zuschauer-Kamera-Leute-beobachten
APP|Programm-Software-Anwendung-Computer-Store
Seestern|Meer-Wasser-Arme-Tier-Himmel
E-Book|Buch-lesen-Computer-Internet-herunterladen
Eisenbahn|Zug-Lokomotive-fahren-Schienen-reisen
Parkkralle|Auto-Rad-fahren-stehlen-Schutz
Windhund|Tier-bellen-rennen-schnell-wetten
Waschstra#ss#e|Auto-sauber-Anlage-fahren-Weg
Stra#ss#enmusik|Instrument-singen-spielen-Geld-Hut
Wunschbrunnen|Wasser-pl#ae#tschern-M#ue#nze-Erf#ue#llung-glauben
Bundesliga|Sport-Fu#ss#ball-Tabelle-Mannschaft-regional
Gewitter|Donner-Blitz-Regen-Wind
Gedicht|Reim-Vers-Literatur-schreiben-Liebe
Mensa|Kantine-Schule-Universit#ae#t-essen-Cafeteria
Golfstrom|Wetter-Wind-Sport-Auto-Steckdose
Einrad|fahren-zwei-Lenker-Pedal-Balance
Maulesel|Pferd-reiten-Sattel-Kreuzung-Mund
Postkarte|Brief-Urlaub-Ferien-Bild-Marke
Minigolf|Platz-Schl#ae#ger-Loch-klein-spielen
Markt|Stand-kaufen-H#ae#ndler-frisch-schreien-super
Torte|Kuchen-Obst-Schokolade-Sahne-Geburtstag
Doping|Sport-Mittel-verboten-besser-Kontrolle
Avatar|Internet-Person-virtuell-k#ue#nstlich-Film
DSDS|Castring-Show-Fernsehen-singen-Bohlen
Err#oe#ten|Gesicht-Wange-peinlich-sch#ae#men-Aufregung
Gold|Metall-Silber-wertvoll-Ring-Medallie
Blog|Internet-Web-online-schreiben-lesen
Mikrofon|sprechen-singen-laut-aufnehmen-Radio
Lamm|Schaf-jung-klein-Tier-s#ue##ss#
Shoppingkanal|Fernsehen-Sender-Programm-kaufen-QVC
Zitteraal|Fisch-Wasser-Strom-lang-Schlange
Wirbelsturm|Wetter-Wind-Regen-Hurrikan
Ananas|Frucht-Obst-s#ue##ss#-Scheibe-Dose
Presse|Maschine-dr#ue#cken-Zeitung-Reporter-Regenbogen
Huckepack|R#ue#cken-tragen-nehmen-Schultern-Kind
Zitrone|Frucht-Obst-gelb-sauber-Orange
Auktion|Versteigerung-bieten-Betrag-Hammer-Zuschlag
Gift|Stoff-krank-K#oe#rper-sterben-Mord
SMS|Nachricht-Text-Handy-schicken-lesen
Erdbeere|Obst-rot-pfl#ue#cken-Sommer-Sahne
Seetang|Algen-Meer-Wasser-unten-gr#ue#n
Anzug|Hose-Jacke-Kleidung-tragen-Anlass
Wrestling|Catchen-Ring-Kampf-Sport-Show
Kopfh#oe#rer|Musik-Ohr-lauschen-St#oe#psel-Ton
Schnell|rasch-eilig-fahren-Tempo-langsam
Klippe|K#ue#ste-Felsen-steil-abw#ae#rts-klettern
Schwanger|heiraten-Ehe-Familie-verwandt-Bruder
Beamen|Licht-Strahl-Transport-Star Trek-Scotty
Marathon|Sport-laufen-lang-Kilometer-Ausdauer
Herz|K#oe#fper-Blut-Pumpe-Liebe-Schmerz
Hamster|Tier-K#ae#fig-klein-Rad-Gold
V.I.P.|Promi-Star-wichtig-Lounge-Status
Denglisch|Sprache-Deutsch-Englisch-mischen-Wort
Hammerhai|Fisch-Meer-Wasser-Nagel-bei#ss#en
Junk|Mail-Papierkorb-l#oe#schen-Food-Mist
Marshmallow|s#ue##ss#-wei#ss#-weich-Schaum-Amerika-drau#ss#en
Humor|lachen-Witz-komisch-haben-viel
Seifenoper|Fernsehen-Serie-waschen-Wasser-singen
Geisterstadt|Ort-leer-verlassen-Gespenst-gruselig
Samurai|Japan-Krieger-Adel-Schwert-sieben
Knoblauch|Knolle-Zehe-Zwiebel-Gew#ue#rz-Geruch
Handy|Telefon-sprechen-anrufen-mobil-Funk
Signal|Verbindung-Netz-Handy-Rauch-Zeichen
Fee|M#ae#rchen-Fantasie-Zauberstab-Fl#ue#gel-gut
Rabenmutter|Kind-Eltern-Vater-Vogel-Kr#ae#he
Cowboy|Amerika-Westen-Pferd-Hut-Rind
Science Fiction|Zukunft-Film-Weltraum-Fantasie-morgen
B#oe#ller|Feuerwerk-Knall-Kracher-laut-Silvester
Skateboard|Brett-Rollen-fahren-Stra#ss#e-Trick
Samt|Stoff-Material-weich-Kleidung
Newsletter|eMail-Information-Werbung-Website-Neuigkeit
Botox|Gift-Toxin-Haut-Gesicht-spritzen
Flirten|Liebe-Kontakt-sehen-Blick-Spiel
Ciabatta|Brot-Italien-flach-Baguette-essen
Snowboard|Schnee-Winter-Ski-Berg-fahren
Eifersucht|Neid-haben-Gef#ue#hl-Partner-krank
Cham#ae#leon|Tier-Reptil-Tarnung-Haut-Farbe
Ipad|Tablet-Computer-klein-#ue#berall-Apple
Schwammkopf|SpongeBob-Zeichentrick-Fernsehen-Meer-gelb-Lied
Downloaden|Datei-Internet-online-speichern-Computer
Transformers|Film-Kino-verwandeln-Shia LeBeouf-Optimus Prime
B#ue#gel|Kleider-aufh#ae#ngen-Schrank-Eisen-Brille
Weintraube|Obst-essen-Rebe-gr#ue#n-blau
Feierabend|Arbeit-Schluss-Tag-zuhause-Kneipe
Villa|Haus-Anwesen-gro#ss#-reich-wohnen
Radar|Funk-erkennen-orten-Signal-Antenne
Leberwurst|essen-Fleisch-Brot-streichen-grob
Brandit|Dieb-R#ae#uber-Verbrecher-stehlen-#ue#berfallen
Botschaft|Diplomat-Vertreter-Land-Staat-Nachricht
Endzeit|Katastrophe-vorbei-Welt-Anfang-Uhr
W#ue#rfel|Seiten-Augen-Spiel-Form-rollen
Roboter|Mensch-Maschine-intelligent-Metall-arbeiten
Saturn|Planet-Sonne-Weltraum-Gas-Ring
Roulette|Spiel-Casino-setzen-Kugel-Zahl
Pyramide|Bauwerk-#ae#gypten-Grab-Gizeh-spitz
Anden|S#ue#damerika-Gebirge-kette-hoch-besteigen
#oe#lteppich|Wasser-auslaufen-Pest-Salat-Boden
Haut|K#oe#rper-H#ue#lle-d#ue#nn-Organ-Schutz