Katze|Tier-Haustier-Miauen-Fell-Krallen
Auto|Fahrzeug-fahren-Stra#ss#e-Motor-R#ae#der
Pizza|E#ss#en-Teig-K#ae#se-Belag-Lieferung
Sonne|Himmel-Tag-hei#ss#-leuchten-Sonnenbrille
Fu#ss#ball|Sport-Ball-Mannschaft-Tor-Schiedsrichter
Flugzeug|Transport-Pilot-Flughafen-Himmel-Fl#ue#gel
Buch|Lesen-Seiten-Geschichte-Autor-Kapitel
Kaffee|Getr#ae#nk-Ta#ss#e-hei#ss#-Bohnen-Koffein
Strand|Meer-Sand-Sonnenbaden-Wellen-Muscheln
Geburtstag|Feier-Geschenke-Kuchen-Kerzen-Alter
Computer|Technologie-Bildschirm-Tastatur-Maus-Internet
Regenbogen|Farben-Himmel-Nach dem Regen-Bogen-Sonnenlicht
Schule|Lernen-Lehrer-Sch#ue#ler-Unterricht-Schulranzen
Garten|Pflanzen-Blumen-Rasen-Schaufel-Gie#ss#en
Film|Kino-Schauspieler-Drehbuch-Regi#ss#eur-Popcorn
Musik|Lied-Instrument-Melodie-T#oe#ne-Konzert
Hunde|Tiere-Haustiere-Bellen-Pfoten-Ra#ss#e
Schokolade|S#ue##ss#igkeit-Naschen-Kakao-Tafel-Pralinen
Telefon|Kommunikation-Anrufen-Nummer-Handy-Gespr#ae#ch
Sommer|Jahreszeit-Sonne-Hitze-Urlaub-Eiscreme
Uhr|Zeit-Zeiger-Ziffernblatt-Tick-Tack-Wecker
Brille|Sehen-Augen-Gestell-Linsen-Optiker
Bank|Geld-Finanzen-Sitz-Konto-#UE#berweisung
Zahnarzt|Z#ae#hne-Bohrer-Stuhl-Zahnreinigung-Termin
Ferien|Pause-Reise-Erholung-Freizeit-Auszeit
Baum|Pflanze-Bl#a#tter-Holz-Wurzeln-Schatten
Treppe|Stufen-Aufstieg-Gel#ae#nder-Abstieg-Treppenhaus
Lampe|Beleuchtung-Licht-Schalter-Gl#ue#hbirne-Strom
Meer|Ozean-Wellen-Strand-Fische-Salzwa#ss#er
Sch#ue##ss#el|Kochen-E#ss#en-Inhalt-Rund-K#ue#che
Kino|Filme-Leinwand-Popcorn-Pl#ae#tze-Filmstart
Fahrrad|Radfahren-Drau#ss#en-Fahrzeug-Pedale-Helm
Feuer|Brennen-Flammen-W#ae#rme-Brand-Rauch
Kleidung|Anziehen-Mode-Stil-Kleiderschrank-Modenschau
Uhrzeit|Zeiger-Minuten-Stunden-Zeitplan-Wecker
Himmel|Wolken-Sonne-Sterne-Blau-Flugzeug
Banane|Obst-Gelb-Sch#a#len-#ae#pfel-Schale
Zirkus|Artist-Tiere-Clown-Vorstellung-Akrobatik
Farbe|Malen-Bunt-Pinsel-Leinwand-Farbt#oe#pfe
Reise|Urlaub-Entdecken-Flugzeug-Abenteuer-Koffer
Augen|Sehen-Blicken-Blinzeln-Iris-Brille
Spielzeug|Kind-Spielen-Pl#ae#tzchen-Unterhaltung-Puppe
Apfel|Obst-E#ss#en-Saftig-Birne-Kerngeh#a#use
Tisch|M#oe#bel-E#ss#en-Platz-Beine-Stuhl
Foto|Bild-Erinnerung-Kamera-Aufnahme-Album
Regen|Na#ss#-Wolken-Schirm-Pfuetze-Tropfen
Winter|Kalt-Schnee-Eis-Schnee#ss#el-Schlitten
Himmelbett|Schlafen-Bett-Vorh#a#nge-Romantisch-Nachtruhe
Zebra|Tier-Streifen-Savanne-Afrika-Pferd
Flasche|Trinken-Glas-#UE#berschwappen-Inhalt-Dursten
Badezimmer|Duschen-Toilette-Spiegel-Seife-Handtuch
B#ae#ckerei|Brot-Br#oe#tchen-Verkauf-S#ue##ss#igkeiten-Kuchen
#AE#gypten|Pyramide-Sphinx-W#ue#ste-Pharao-Nil
Teddyb#ae#r|Kuscheln-Stofftier-Kinder-#ae#rmel-Nachtruhe
Ozean|Wa#ss#er-Wellen-Tiefe-Meeresbewohner-K#ue#ste
Kamera|Fotografieren-Bilder-Film-Objektiv-Ausl#oe#ser
Kugelschreiber|Schreiben-Stift-Tinte-Schreibger#ae#t-Kappe
Apotheke|Medikamente-Gesundheit-Tabletten-Rezept-Arzneimittel
Gebirge|Berge-Wandern-Gipfel-Natur-Au#ss#icht
Fernseher|Unterhaltung-Bildschirm-Programm-Fernbedienung-Kabel
Schmetterling|Insekt-Fl#ue#gel-Farben-Fliegen-Nektar
E-Mail|Nachricht-Postfach-Internet-Elektronisch-Versenden
Schere|Schneiden-Papier-Schnitt-Klingen-Handwerk
Schwimmbad|Wa#ss#er-Schwimmen-Becken-Baden-Rutschen
Kuchen|Backen-S#ue##ss#igkeit-Teig-Sahne-Naschen
Arzt|Medizin-Gesundheit-Krankheit-Patient-Untersuchung
Sport|Aktivit#ae#t-Bewegung-Wettbewerb-Team-Sportler
Zoo|Tiere-Au#ss#tellung-Gehege-F#ue#ttern-Tierpfleger
Tasche|Tragen-Handtasche-Gep#ae#ck-Schulterriemen-Rei#ss#verschlu#ss#
Schnee|Winter-Kalt-Eis-Rutschen-Schneemann
Bahn|Transport-Zug-Schienen-Fahrplan-Reisen
Theater|Auff#ue#hrung-B#ue#hne-Schauspiel-Darsteller-Vorhang
Schuh|Fu#ss#-Bekleidung-Schn#ue#rsenkel-Sohle-Gr#oe##ss#e
Keks|Backen-S#ue##ss#igkeiten-Knuspern-Knabberei-Keksdose
Handy|Telefonieren-Kommunikation-Mobilger#ae#t-Nachrichten-Apps
Malen|Farben-Kunst-Kreativit#ae#t-Leinwand-Pinsel
Fr#ue#hling|Jahreszeit-Blumen-Gr#ue#n-Erwachen-Vogelgezwitscher
Hund|Haustier-Bellen-Wedeln-Fell-Pfote
Zeitung|Nachrichten-Pre#ss#e-Artikel-Lesen-Drucken
Ta#ss#e|Trinken-Becher-Hei#ss#-Kaffee-Tee
Zahn|Gebi#ss#-Mundarzt-Bei#ss#er-Karies-Pflege
Fahne|Symbol-Nation-Flagge-Stoff-Stange
Geb#ae#ude|Bauwerk-Architektur-Steine-Fa#ss#ade-Dach
Bahnsteig|Zug-Bahn-Reisende-Gleis-Ankunft
Gitarre|Musik-Instrument-Saiten-Spiel-Melodie
Freunde|Gesellschaft-Gemeinsamkeit-Beziehung-Vertrauen
Blume|Pflanze-Duft-Garten-Sch#ue#nheit-Bl#ue#te
Schl#ue#ssel|Schloss-T#ue#r-#OE#ffnen-Sicherheit-Bund
Korb|Beh#ae#lter-Tragen-Einkaufen-Flechten-Picknick
Kopfh#oe#rer|Musik-H#oe#ren-Klang-Ohren-Stecker
K#ue#hlschrank|K#ue#hlen-Lebensmittel-Ger#ae#usch-Eisfach-T#ue#r
Hase|Tier-Kaninchen-Ohren-Hoppeln-M#oe#hre
Kugel|Rund-Ball-Spiel-Schwer-Kreis
Schl#ue##ss#elbund|Schl#ue##ss#el-Anh#ae#nger-T#ue#r-Bund-Metall
Fotoalbum|Erinnerung-Bilder-Familie-Freunde-Einstecken
Schublade|Aufbewahrung-M#oe#bel-Griff-Herausziehen-Ordnung
Rucksack|Tragen-Wandern-Tasche-Reisen-Gurt
Regenschirm|Regen-Trocken-Himmel-N#ae##ss#en-Sturm
Wiese|Gras-Natur-Blumen-Sonnenstrahlen-Picknick
Fernglas|Beobachten-Vergr#oe##ss#erung-Glas-Sicht-Fokus
Schl#ue##ss#elbrett|Aufh#ae#ngen-Organisieren-Schl#ue##ss#elhaken-Flur-Wand
Sonnenbrille|Schutz-Augen-T#oe#nung-UV-Strahlen
Bleistift|Schreiben-Zeichnen-Grafit-Spitzen-Radieren
Magnet|Anziehung-Metall-Magnetfeld-Magnetschwebebahnen
Zitrone|Frucht-Sauer-Saftig-Gelb-Erfrischend
Fernbedienung|Steuerung-Fernseher-Kan#ae#le-Lautst#ae#rke-Programme
Blatt|Baum-Gr#ue#n-Herbst-Bl#ae#tterrascheln
Aquarium|Fische-Wa#ss#er-Gl#a#ser-Dekoration-Unterwa#ss#erwelt
Puzzle|Legespiel-Teile-Bild-Geduld-Knobeln
Schrank|Aufbewahrung-Kleidung-Schubladen-Kleiderb#ue#gel-Regal
Kekse|Backen-S#ue##ss#igkeit-Knuspern-Teig-Naschen
Park|Natur-Spazieren-Gr#ue#n-Picknick-B#ae#ume
Badeanzug|Schwimmen-Strand-Pool-Sommer-Baden
Kuscheltier|Stofftier-Knuddeln-Kinder-Nachtruhe-Tr#oe#sten
Telefonbuch|Nummern-Adre#ss#en-Kontakte-Telefonnummern-Auswahl
Regenmantel|Wetterschutz-Regen-Jacke-Regenschirm-Trocken
Schuhe|Fu#ss#-Bekleidung-Sohle-Schn#ue#rsenkel-Gr#oe##ss#e
Kinderzimmer|Spielen-Schlafen-Spielzeug-Bett-Kinder
Buchstaben|Worte-Schrift-Sprache-Alphabet-Lesen
Handschuhe|H#ae#nde-W#ae#rme-Finger-K#ae#lte-Schutz
Torte|Backen-S#ue##ss#igkeit-Sahne-Geburtstag-St#ue#ck
Kompa#ss#|Navigation-Richtung-Nadel-Nord-S#ue#d
Hafen|Schiffe-Boote-Anker-Meer-Kr#ae#ne
Teekanne|Tee-Hei#ss#-Ausgie#ss#en-Griff-Porzellan
Fahrradhelm|Sicherheit-Radfahren-Kopfschutz-Sturz-Verkehr
Hausaufgaben|Schule-Lernen-Aufgaben-Hausarbeit-Schreiben
Instrument|Musik-Klavier-Gitarre-Trommel-Noten
Feuerwehr|L#oe#schen-Brand-Alarm-Feuerwehrauto-Feuer
Topf|Kochen-E#ss#en-K#ue#che-Herd-Deckel
Stift|Schreiben-Zeichnen-Schule-Farbe-Kugelschreiber
Camping|Zelt-Natur-Feuer-Rucksack-Abenteuer
Geldb#oe#rse|Geld-Karten-Bargeld-Brieftasche-Geldbeutel
Handschellen|Polizei-Fe#ss#eln-Festhalten-Schl#ue##ss#el-Gefangener
Wolken|Himmel-Regen-Sonne-Grau-Formen
Skateboard|Rollen-Sport-Balance-Board-Tricks
Schulbus|Schule-Fahrzeug-Kinder-Fahrt-Busfahrer
H#ue#hnerei|Ei-Omelett-Kochen-Sch#a#len-Eigelb
Dusche|Wa#ss#er-Erfrischung-Bad-Shampoo-Abbrausen
Sonnenaufgang|Morgen-Horizont-Himmel-Rot-Neuer Tag
Schl#ue##ss#elanh#ae#nger|Schl#ue##ss#el-Ring-Anh#ae#nger-Tasche-Anh#ae#ngsel
Kreide|Schreiben-Tafel-Farbig-Kritzeln-Staub
Sonnenuntergang|Abend-Horizont-Himmel-Rot-D#ae#mmerung
Schal|Hals-W#ae#rme-Strick-Acce#ss#oire-Muster
Hubschrauber|Fliegen-Luft-Rotor-Rettung-Pilot
Rezept|Kochen-K#ue#che-Zutaten-Anleitung-Kochbuch
Laterne|Licht-Dunkelheit-Stra#ss#e-Lampe-Batterie
Br#ue#cke|#UE#berqueren-Flu#ss#-Konstruktion-Verbindung-Architektur
Ohrringe|Schmuck-Ohren-Stecker-Perlen-Gold
Einkaufswagen|Einkaufen-Supermarkt-Rollen-Lebensmittel-Ka#ss#e
Picknick|E#ss#en-Natur-Decke-Korb-Park
Ball|Spiel-Sport-Rund-Kicken-Werfen
Sandburg|Strand-Sand-Wa#ss#er-Bauen-K#ue#ste
Schneemann|Winter-Schnee-Karotte-M#ue#tze-Schneeball
Teller|E#ss#en-Servieren-Porzellan-Abwasch-Speisen
Rennauto|Geschwindigkeit-Rennen-Strecke-Motorsport-Fahrer
Taschenlampe|Licht-Dunkelheit-Batterie-Tasche-Beleuchtung
Hosen|Kleidung-Beine-Stoff-H#ue#fte-Knopf
Fisch|Wa#ss#er-Schwimmen-Flo#ss#en-Aquarium-Salzwa#ss#er
Kaffeeta#ss#e|Trinken-Kaffee-Hei#ss#-Morgen-Genie#ss#en
Mikrofon|Sprechen-Stimme-Gesang-Aufnahme-B#ue#hne
Portemonnaie|Geldb#oe#rse-Geld-Karten-Bargeld-Brieftasche
Trampolin|Springen-Sport-Federung-H#ue#pfen-#UE#bung
Rennrad|Radfahren-Stra#ss#e-Sport-Geschwindigkeit-Tour
Schaukel|Spielplatz-Hoch-Spa#ss#-Kind-Schwingen
Planet|Weltall-Sonne-Sterne-Erde-Galaxie
Tischtennis|Schl#ae#ger-Ball-Netz-Spiel-Aufschlag
Wolkenkratzer|Hochhaus-Geb#ae#ude-Wolken-H#oe#he-Architektur
Kerze|Feuer-Docht-Duft-Wachs-Leuchten
Segelboot|Segeln-Wa#ss#er-See-Wind-Segel
Dinosaurier|Urzeit-Ausgestorben-Fo#ss#ilien-Echse-Pr#ae#historisch
H#ae#ngematte|Entspannen-Schaukeln-Garten-Sommer-Urlaub
Tafel|Schreiben-Kreide-Schule-Unterricht-L#oe#schen
Boot|Wa#ss#er-See-Flu#ss#-Rudern-Kapit#ae#n
Brief|Schreiben-Nachricht-Post-Zustellung-Umschlag
Radio|Musik-Nachrichten-Sender-Tuner-Lautsprecher
Schlo#ss#|T#ue#r-Schl#ue##ss#el-Burg-Mittelalter-Geheimnis
Volleyball|Sport-Netz-Ball-Aufschlag-Beachvolleyball
Eiscreme|Lecker-Schmelzen-Sommer-Genu#ss#-Eiswaffel
Kamm|Haare-Frisur-B#ue#rsten-Z#ae#hne-Haarpflege
Seil|Knoten-Ziehen-Sicherheit-Kletterei-Schaukel
Kaktus|Pflanze-Stachel-W#ue#ste-Sukkulente-Topf
Frosch|Tier-Quaken-Teich-Lurch-H#ue#pfen
Zelt|Camping-Schlafen-Natur-Abenteuer-Outdoor
Basketball|Sport-Korb-Ball-Wurf-Team
Luftballon|Luft-Feiern-Bunt-Helium-Geburtstag
Eule|Vogel-Nacht-Weisheit-Federn-Augen
Rakete|Weltraum-Start-Feuerwerk-Wi#ss#enschaft-Raumfahrt
Teppich|Boden-Weich-Textur-Wohnzimmer-Muster
Spinne|Insekt-Netz-Acht-Beine-Krabbeln
Hammer|Werkzeug-Nagel-Schlagen-Holz-Handgriff
Armbanduhr|Zeit-Handgelenk-Uhrzeit-Zifferblatt-Armband
Seepferdchen|Meer-Tier-Unterwa#ss#er-Schwimmen-Fisch
Laptop|Computer-Technologie-Internet-Bildschirm-Tastatur
H#ue#tte|Holz-Blockhaus-Gem#ue#tlich-Berg-Holzh#ue#tte
Feder|Vogel-Fliegen-Weich-Schreiben-Luftig
Kirsche|Obst-Rot-Saftig-Kern-Fr#ue#hling
Segelschiff|Segeln-Wa#ss#er-See-Wind-Segel
Schaukelpferd|Spielzeug-Kinder-Reiten-Schaukeln-Holz
Pinguin|Tier-Eis-K#ae#lte-Schwarz-Wei#ss#-Tierpark
Melone|Frucht-Sommer-Saftig-Kerne-Schale
Gl#ue#hbirne|Licht-Strom-Energie-Leuchten-Birne
Tischdecke|Tisch-E#ss#en-Abdeckung-Tuch-Geschirr
Kuh|Tier-Milch-Bauer-Weide-Muh
Zahnspange|Z#ae#hne-Kiefer-Klammer-Korrigieren-Ortodontie
Eis|Kalt-Lecker-Schmelzen-Sommer-Erfrischung
Baseball|Sport-Schl#ae#ger-Ball-Team-Spiel
Lippenstift|Schminke-Farbe-Lippen-Make-up-Auftragen
Schildkr#oe#te|Tier-Panzer-Langsam-Gr#ue#n-Reptil
Wa#ss#erfall|Wa#ss#er-Natur-Strom-Sturz-Bach
Flip-Flops|Schuhe-Sommer-Sandalen-Strand-F#ue##ss#e
Maus|Computer-Klicken-Scrollen-Kabellos-Nager
Zaun|Garten-Trennung-Holz-Grenze-Weidezaun
Baumhaus|Holz-H#oe#hle-Klettern-Kinder-Baum
Zauberer|Magie-Hut-Stab-Zaubern-Kost#ue#m
Surfbrett|Strand-Wellen-Surfen-Brett-Wa#ss#er
Meerjungfrau|Mythologie-Fantasy-Fischschwanz-Schwimmen-Meer
K#ue#rbis|Herbst-Orange-Halloween-Schnitzen-Gruselig
Einhorn|Fantasie-Pferd-Magie-Horn-M#ae#rchen
Sonnenblume|Pflanze-Gelb-Sommer-Sonne-Kerne
Schneeflocke|Winter-Kalt-Eis-Kristall-Schnee
Teleskop|Beobachten-Sterne-Weltraum-Galaxie-Vergr#oe##ss#erung
Rennwagen|Auto-Geschwindigkeit-Rennen-Fahrer-Start
Ballon|Luft-Feiern-Bunt-Helium-Geburtstag
Berg|Gipfel-Natur-Wandern-H#oe#he-Schnee
Krokodil|Tier-Flu#ss#-Z#ae#hne-Wa#ss#er-Schnapp
Drache|Fantasie-Feuer-Fliegen-Mythologie-Schuppen
Salat|Gem#ue#se-Gesund-E#ss#en-Blattgr#ue#n-Dre#ss#ing
Krawatte|Kleidung-Hemd-Acce#ss#oire-Bindung-Hals
Schiff|Wa#ss#er-Boot-Kapit#ae#n-Meer-Kreuzfahrt
M#ue#cke|Insekt-Summen-Stechen-Blut-Schwirren
Jeans|Hose-Denim-Mode-Beine-Taschen
Taube|Vogel-Frieden-Fliegen-Wei#ss#-Tier
Angel|Fischen-Haken-See-Rute-K#oe#der
Schlange|Tier-Giftig-Kriechen-Haut-Zisch
Einrad|Fahren-Rad-Balance-Zirkus-Einradfahren
Tropisch|W#ae#rme-Palmen-Strand-Exotisch-Klima
Sanduhr|Zeit-Stunden-Minuten-Sand-Z#ae#hlen
Biene|Insekt-Honig-Stachel-Summen-Blume
Flamingo|Vogel-Rosa-Beine-See-Tropisch
Seifenblase|Blasen-Schaum-Spiel-Bunt-Platzen
Wa#ss#erhahn|Wa#ss#er-Leitung-Drehen-Fl#ue##ss#igkeit-K#ue#che
Kreisel|Spielzeug-Drehen-Schnur-Kinder-Balance
Palme|Baum-Tropisch-Strand-Urlaub-Kokosnu#ss#
Schlitten|Winter-Schnee-Fahren-Rodeln-Kufen
Einladung|Feier-Empfang-Einladen-Gast-Karte
Eiffelturm|Paris-Frankreich-Wahrzeichen-Stahl-H#oe#he
Melodie|Musik-Klang-Ton-Lied-Noten
Sonnenschein|Himmel-Licht-W#ae#rme-Gl#ue#cklich-Strahlen
Flipchart|Pr#ae#sentation-Papier-St#ae#nder-Schreiben-Visualisieren
Giraffe|Tier-Hals-Flecken-Savanne-Lang
Handtasche|Mode-Tragen-Geld-Acce#ss#oire-Schulter
Trommel|Musik-Instrument-Rhythmus-Schlagen-Sticks
Bienenstock|Insekt-Honig-Bienen-Waben-Stechen
Schneeball|Winter-Schnee-Kugel-Werfen-Wei#ss#
Sonnenschirm|Sonne-Strand-Schutz-Schatten-Halterung
Federball|Sport-Schl#ae#ger-Netz-Spiel-Feder
Papagei|Tier-Vogel-Bunt-Schnabel-Schwanz
W#ue#rfel|Spiel-Zahlen-Seitenwurf-Kanten
Wolke|Himmel-Wei#ss#-Regen-Wetter-Flauschig
Handschuh|Hand-W#ae#rme-Finger-Schutz-Handschuhfach
Motorrad|Fahren-Fahrzeug-Zweirad-Geschwindigkeit-Helm
Clown|Zirkus-Lachen-Kost#ue#m-Roten-Nase
Stethoskop|Arzt-H#oe#ren-Herz-Atem-Medizin
Schleife|Knoten-Bindung-Schmuck-Geschenk-Schleifenband
Murmeln|Spiel-Kugeln-Glasmurmeln-Rollen-Runde
Trompete|Musik-Instrument-Blasen-Musiker-Gold
Delfin|Tier-Meer-Springen-Wa#ss#er-Schwimmen
Mikroskop|Wi#ss#enschaft-Labor-Vergr#oe##ss#erung-Bakterien-Zelle
Gummib#ae#rchen|S#ue##ss#igkeiten-Naschen-Gelatine-Bunt-Fruchtig
Ballett|Tanz-Kla#ss#isch-B#ue#hne-T#ae#nzer-Spitze
Waffel|E#ss#en-Teig-S#ue##ss#-Fr#ue#hst#ue#ck-Zucker
Fuchs|Tier-Wald-Schlaues-Gesicht-Schwanz
Stuhl|Sitzm#oe#bel-Beine-R#ue#cken-Lehne-Sitzen
K#oe#nig|Herrscher-Krone-Thron-Macht-Majest#ae#t
Banjo|Musik-Instrument-Saiten-Klang-Spielen
Mond|Himmel-Nacht-Silber-Rund-Sterne
Koffer|Reisen-Gep#ae#ck-Packen-Rollen-Schlie#ss#en
Roboter|Technologie-Metall-Programmieren-Zukunft-K#ue#nstlich
Sofa|M#oe#bel-Sitzen-Gem#ue#tlich-Wohnzimmer-Polsterung
Lupe|Vergr#oe##ss#erung-Glas-Detail-Klein-Lesen
Kaugummi|Kauen-S#ue##ss#igkeit-Geschmack-Blasen-Klebrig
F#oe#hn|Haare-Trocknen-Haartrockner-Luft-W#ae#rme
Krone|K#oe#nig-Prinze#ss#in-Edel-Gold-Herrschertitel
Salzstreuer|Gew#ue#rz-E#ss#en-K#ue#che-Streuen-Geschmack
L#oe#we|Tier-Br#ue#llen-M#ae#hne-Savanne-K#oe#nig
Bett|Schlafen-Schlafzimmer-Nacht-Ruhe-Schlaf
Bus|Fahrzeug-Transport-Buslinie-Fahren-Personen
Ei|Lebensmittel-Kochen-Huhn-Schale-Eigelb
Finger|Hand-Ber#ue#hren-Fingernagel-Handy-Z#ae#hlen
Glas|Trinken-Durchsichtig-Bruch-Glaswaren-Fenster
Haus|Zuhause-Geb#ae#ude-Dach-T#ue#r-Fenster
Insel|Land-Wasser-Meer-Tropisch-Strand
Obst|Essen-Gesund-Vitamine-Saftig-Obstkorb
Pferd|Tier-Galoppieren-Sattel-Huf-M#ae#hne
Tasse|Trinken-Tee-Kaffee-Becher-Hei#ss#
Vogel|Tier-Fliegen-Federn-Zwitschern-Nest
Wasser|Trinken-Fl#ue#ssigkeit-Durst-Quelle-Meer
Wind|Luft-Blasen-Wehen-Sturm-Windm#ue#hle
Zug|Transport-Bahn-Reisen-Lokomotive-Gleise
Zuhause|Haus-Familie-Ort-Gem#ue#tlich-Ruhe
Gartenarbeit|Pflanzen-Garten-Schubkarre-Gie#ss#en-Blumen
Grill|Essen-Feuer-Grillen-Fleisch-Rauch
Hand|K#oe#rper-Finger-Arm-Greifen-Schreiben
Huhn|Tier-Ei-Hof-Gackern-Braten
K#ae#se|Essen-Milch-Loch-Gouda-Lecker
Leiter|Klettern-Hoch-Lehre-Sprossen-Wand
Luft|Atmen-Sauerstoff-Himmel-Leicht-Ballon
Milch|Trinken-Kuh-Eiwei#ss#-Gesund-Kakao
M#ue#tze|Kopf-K#ae#lte-Hut-Winter-M#ue#tzenmacher
Nase|Gesicht-Riechen-Atmen-Schnupfen-Bohren
Ohr|H#oe#ren-Ger#ae#usch-Geh#oe#r-Geh#oe#rgang-Lauschen
Orange|Frucht-Saftig-Zitrus-Essen-Orange
Pfanne|Kochen-Braten-Essen-Griff-Antihaft
Rad|Fahren-Radfahren-Fahrrad-Drau#ss#en-Speichen
Ring|Schmuck-Hand-Finger-Diamant-Verlobung
Saft|Trinken-Frucht-Erfrischung-Fl#ue#ssigkeit-Orangensaft
Sand|Strand-Strandkorb-Schloss-Burgen-Badestrand
Schloss|Burg-Tor-Schl#ue#ssel-K#oe#nig-Ritter
Schwimmen|Wasser-Sport-Schwimmbad-Tauchen-Beckenrand
Seife|Waschen-Duschen-Duftend-Schaum-Seifenblase
Teich|Wasser-Natur-Fische-Enten-Teichfolie
Tomate|Gem#ue#se-Essen-Rot-Salat-Saftig
Uhu|Vogel-Nacht-Weisheit-Federn-Augen
Wald|B#ae#ume-Natur-Wandern-Tiere-Waldweg
Waschmaschine|Waschen-Kleidung-Waschmittel-Schleudern-Programm
Wein|Trinken-Rot-Wei#ss#-Trauben-Genuss
Affe|Tier-Dschungel-Baum-Banane-Schimpansen
B#ae#r|Tier-Wildnis-H#oe#hle-Krallen-Pelz
Elefant|Tier-R#ue#ssel-Sto#ss#zahn-Savanne-Riesen
Ente|Tier-Quaken-Wasser-Feder-Teich
Gans|Tier-Schnattern-Feder-G#ae#nsehaut-Fliegen
Garage|Parken-Auto-Tor-Werkstatt-Fahrzeug
Panda|Tier-Bamboo-Schwarz-Wei#ss#-B#ae#r
Robbe|Tier-Wasser-Robbenbaby-Fisch-Arktis
Schaf|Tier-Wolle-Herde-Weide-Bl#oe#ken
Schnecke|Tier-Haus-Gleiten-Schleim-Spirale
Stra#ss#e|Verkehr-Auto-Gehweg-Asphalt-Kreuzung
Tiger|Tier-Katze-Streifen-Raubtier-Dschungel
V#oe#gel|Tiere-Fliegen-Federn-Zwitschern-Nest
Wal|Tier-Ozean-Wasser-Meeresbewohner-Schwimmen
Wolf|Tier-Heulen-Rudel-Wildnis-Fell
Apfelsine|Frucht-Saftig-Orange-Zitrus-Essen
Birne|Frucht-Essen-Baum-Obst-Saftig
Butter|Essen-Streichfett-Milch-Fr#ue#hst#ue#ck-Aufstrich
Dose|Beh#ae#lter-Konserven-Getr#ae#nk-Metall-Deckel
Hamburger|Essen-Burger-Br#oe#tchen-Fleisch-Beilage
Hut|Kopf-Deckel-Sonnenhut-M#ue#tze-Krempe
K#ae#fer|Tier-Kriechen-K#ae#ferchen-Fliegen-Schildkr#oe#tenk#ae#fer
Klavier|Instrument-Musik-Tasten-Klang-Klavierspielen
L#oe#ffel|Essen-Besteck-Suppe-R#ue#hren-Essl#oe#ffel
Nuss|Essen-Knacken-Schale-Knackig-Walnuss
Plastik|Material-Umweltverschmutzung-Recycling-Kunststoff-Verpackung
Radiergummi|Schreiben-Radierer-Striche-Feinmotorik-Radieren
Reifen|Auto-Fahrzeug-Stra#ss#e-Luft-Gummi
Rose|Blume-Duft-Rot-Garten-Sch#oe#n
Sandkasten|Spielplatz-Sand-Buddeln-Schaufel-Kinder
Schwamm|Putzen-Reinigen-Aufsaugen-Feucht-Abwaschen
Storch|Tier-Nest-Nachwuchs-Fliegen-Vogel
Strau#ss#|Vogel-Federn-Afrika-Eier-Laufen
Wasserhahn|Wasser-Leitung-Abwaschen-K#ue#che-Bad
Welle|Meer-Wasser-Strand-Brandung-Surfen
Zunge|Mund-Geschmack-Sprechen-Lecken-F#ue#hlen
Zwiebel|Gem#ue#se-Kochen-Schneiden-Weinen-Geschmack
Apfelbaum|Frucht-Baum-Bl#ue#te-Obst-Gr#ue#n
Butterbrot|Essen-Brot-Aufstrich-Butter-Stulle
Diamant|Edelstein-Wertvoll-Schmuck-Kar#ae#t-Schliff
Gartenzaun|Haus-Garten-Holz-Zaun-Tor
Hemd|Kleidung-Kragen-#AE#rmel-Bluse-B#ue#geln
Honig|S#ue##ss#-Biene-Natur-Gesund-Streich
Kleeblatt|Gl#ue#ck-Pflanze-Gr#ue#n-Vierbl#ae#ttrig-Irland
Kompass|Navigation-Richtung-Weg-Norden-Kompassrose
Korkenzieher|#OE#ffnen-Flasche-Wein-Korken-Entkorken
Krabbe|Tier-K#ue#ste-Schere-Panzer-Krabbeln
Leuchtturm|Meer-K#ue#ste-Leuchtfeuer-Schiff-Leiten
Pilz|Essen-Giftig-Wald-Spore-Wachstum
Pirat|Seer#ae#uber-Schatz-Kapit#ae#n-Karibik-S#ae#bel
Stiefel|Schuhe-Winter-Leder-Waden-Kniestr#ue#mpfe
Turm|Geb#ae#ude-H#oe#he-Spitze-Burgturm-Aussicht
Vogelhaus|Nistkasten-F#ue#ttern-V#oe#gel-Garten-Holz
Ziege|Tier-Bock-M#ae#hne-Milchziege-Weiden
Ananas|Frucht-Tropisch-S#ue##ss#-Exotisch-Saftig
Astronaut|Weltraum-Raumfahrt-Rakete-Mond-Schwerelosigkeit
Bananenschale|Frucht-Rutschig-Sch#ae#len-Gelb-M#ue#ll
Eichh#oe#rnchen|Tier-N#ue#sse-Baum-Fell-Herbst
Eisb#ae#r|Tier-Polar-Schnee-Arktis-Robbe
Gabel|Essen-Besteck-Gabelzinken-Zinken-Heben
Smartphone|Telefon-Apps-Internet-Kamera-Touchscreen
Kabel|Verbindung-Elektrizit#ae#t-Stecker-#UE#bertragung-Draht
Tablet|Touchscreen-Apps-Portabel-Internet-Display
Netzwerk|Verbindung-Kommunikation-Router-Daten-Internet
Chip|Halbleiter-Integration-Elektronik-Schaltkreis-Prozessor
Batterie|Energie-Stromversorgung-Wiederaufladbar-Lithium-Ionen
VR-Brille|Virtual Reality-3D-Headset-Immersion-Simulation
Drohne|Flugzeug-Kamera-Fernsteuerung-Luftaufnahmen-Quadcopter
GPS|Navigation-Satellit-Standort-Bestimmung-Kartendienste
Cloud|Speicher-Daten-Server-Online-Zugriff
3D-Drucker|Additive Fertigung-Prototypen-Herstellung-Plastik-Technologie
WLAN|Wireless-Netzwerk-Internet-Router-Verbindung
Bluetooth|Drahtlos-Kommunikation-Verbindung-Headset-#UE#bertragung
Sensor|Messung-Erkennung-Temperatur-Licht-Bewegung
Webcam|Kamera-Video-Chat-Online-Streaming
Elektroauto|E-Mobilit#ae#t-Batterie-Ladestation-Nachhaltig-Null-Emissionen
Virtual Reality|VR-Brille-Immersive Erfahrung-Simulation-Gaming
K#ue#nstliche Intelligenz|KI-Maschinelles Lernen-Algorithmen-Automatisierung-Deep Learning
Server|Computer-Datenbank-Hosting-Webseite-Speicherplatz
Cybersecurity|Datenschutz-IT-Sicherheit-Hacker-Netzwerksicherheit
App|Anwendung-Smartphone-Software-Download-Funktion
Elektronik|Ger#ae#te-Stromkreis-Komponenten-Technologie-Schaltung
Code|Programmierung-Entwicklung-Programm-Software-Algorithmen
Hologramm|3D-Projektion-Lichtwellen-Bild-Visualisierung
Augmented Reality|AR-Technologie-Virtuelle Elemente-Echtzeit-Erweiterte Realit#ae#t
Nanotechnologie|Materialforschung-Mikroskopie-Partikel-Technologischer Fortschritt
Biometrie|Identifikation-Sicherheit-Scanner-Biologische Merkmale-Zugangskontrolle
USB|Anschluss-Daten#ue#bertragung-Speichermedium-Stecker-Kabel
Algorithmus|Berechnung-Datenverarbeitung-Logik-Schrittfolge
Software|Programme-Anwendungen-Computerprogramme-Entwicklung-Installation
Firewall|Netzwerksicherheit-Datenschutz-Zugriffskontrolle-Filterung
Drohnenlieferung|Paket-Drohne-Lieferung-Drohnenpost-Logistik
5G|Kommunikation-Mobilfunknetz-Schnelles Internet-Daten#ue#bertragung
Elektromobilit#ae#t|Nachhaltigkeit-Elektrofahrzeuge-Ladeinfrastruktur-Umweltfreundlich
Virtual Assistant|Sprachsteuerung-KI-Technologie-Smart Home-Amazon Alexa
Big Data|Datenanalyse-Datenspeicherung-Informationen-Massenhafte Daten-Data Mining
Robotik|Automatisierung-Maschinen-Industrie-Technologie-Programmierung
Internet of Things|IoT-Vernetzung-Smart Home-Sensoren-Netzwerk
Biometrischer Scanner|Identifikation-Sicherheit-Zugriffskontrolle-Fingerabdruck-Gesichtserkennung
Quantum Computing|Quantenphysik-Quantenalgorithmen-Superposition-Berechnung
Machine Learning|Maschinelles Lernen-KI-Algorithmen-Trainieren-Datenanalyse
Elektrisches Skateboard|E-Mobilit#ae#t-Fortbewegung-Fahrzeug-Batterie-Skateboarding
Smartwatch|Uhr-Intelligente Funktionen-Tracking-Apps-Gesundheit
RFID|Identifikation-Chip-Drahtlose Kommunikation-Datentransfer-Technologie
Solarenergie|Erneuerbare Energie-Sonnenlicht-PV-Anlage-Nachhaltigkeit
Haptisches Feedback|Taktiles Feedback-Ber#ue#hrungsempfindung-Sinneseindruck-R#ue#ckmeldung
Autonome Fahrzeuge|Selbstfahrende Autos-K#ue#nstliche Intelligenz-Sicherheit-Mobilit#ae#t
Virtuelle Simulation|Computergest#ue#tzt-Training-Realit#ae#tsn#ae#he-Interaktion-Immersive Erfahrung
Tastatur|Eingabeger#ae#t-Tasten-Schreiben-Computer-QWERTZ
Monitor|Bildschirm-Anzeige-Display-Flachbildschirm-Aufl#oe#sung
Lautsprecher|Audio-Ton-Akustik-Sound-Boxen
Drucker|Ausdruck-Papier-Tinte-Scannen-Kopieren
USB-Stick|Speichermedium-Dateien-Transportieren-Plug-and-Play-Daten
CD|Datentr#ae#ger-Musik-Disc-Compact Disc-Daten
DVD|Film-Video-Disc-Unterhaltung-Digitales Format
Router|Internet-Netzwerk-WLAN-Verbindung-Signal
Batterieladeger#ae#t|Aufladen-Stromversorgung-Wiederaufladbar-Energie
Digitalkamera|Fotografie-Bilder-Speicher-Kompakt-Sensor
Festplatte|Speicher-Daten-Hardware-Computer-Extern
Akku|Energie-Batterie-Ladung-Elektroger#ae#te-Mobilger#ae#te
Kopfh#oe#rerverst#ae#rker|Audio-Musik-Ausgang-Klang-Verst#ae#rkung
Gamepad|Controller-Spiele-Konsolen-Steuerung-Tasten
Kabelmanagement|Organisation-Kabel-Ordnung-Kabelbinder
Speicherkarte|Daten-Speichermedium-Kapazit#ae#t-Fotografie
Scanner|Digitalisieren-Dokumente-Bild-Erkennung-Flachbett
Ethernet|Netzwerk-Verbindung-Kabel-Internet-Geschwindigkeit
CPU|Prozessor-Hardware-Leistung-Rechenzentrum-Gehirn
USB-Hub|Anschluss-Mehrere-Ger#ae#te-Verteiler-Peripherieger#ae#te
HDMI|Anschluss-Audio-Video-#UE#bertragung-HD-Qualit#ae#t
Betriebssystem|Software-Computer-Steuerung-Funktionen-Anwendungen
Monitorst#ae#nder|Ergonomie-Bildschirm-H#oe#he-Verstellbar
Netzteil|Stromversorgung-Elektronik-Ger#ae#te-Energie-Adapter
Bluetooth-Kopfh#oe#rer|Drahtlos-Musik-Verbindung-Freiheit
Multifunktionsdrucker|Drucken-Kopieren-Scannen-Faxen-All-in-One
Touchscreen|Bildschirm-Ber#ue#hrung-Bedienung-Interaktion-Display
LED-Lampe|Beleuchtung-Energieeffizienz-Leuchtmittel-Helligkeit
Tintenpatrone|Drucker-Tinte-Nachf#ue#llen-Druckqualit#ae#t-Farbe
Webcam-Abdeckung|Privatsph#ae#re-Sicherheit-Kamera-Sichtschutz
Powerbank|Aufladen-Mobilger#ae#te-Batterie-Externer Akku
SIM-Karte|Mobilfunknetz-Daten-Telefonie-Telekommunikation
USB-C|Anschluss-Daten#ue#bertragung-Stecker-Schnellladung
Laptop-St#ae#nder|Ergonomie-Tragbar-H#oe#he-Winkel
Gaming-Headset|Spiele-Audio-Mikrofon-Immersives Erlebnis
Laserdrucker|Drucken-Schnell-Toner-Textqualit#ae#t
Netzkabel|Stromversorgung-Kabel-Elektronik-Stecker
HDMI-Kabel|Audio-Video-#UE#bertragung-HD-Qualit#ae#t
Touchpad|Eingabeger#ae#t-Maus-Notebook-Ber#ue#hrung-Steuern
SSD-Festplatte|Speicher-Schnell-Zuverl#ae#ssig-Flash-Speichermedium
Webcam-Stativ|St#ae#nder-Kamera-H#oe#henverstellbar-Neigungswinkel
Powerline-Adapter|Netzwerk-Internet-Steckdose-Daten#ue#bertragung
CPU-K#ue#hler|Prozessor-K#ue#hlung-Komponente-L#ue#fter-#UE#berhitzung
Smart-Home|Vernetzung-Internet der Dinge-Automatisierung-Smart Devices
Bluetooth-Lautsprecher|Drahtlos-Musik-Verbindung-Portabel-Klangqualit#ae#t
Gaming-Maus|Spielen-Eingabeger#ae#t-Pr#ae#zision-Programmierbare Tasten-Scrollrad
HDMI-Splitter|Bildschirm-Verteilung-Mehrere Anzeigen-Aufl#oe#sung
WLAN-Repeater|Signalverst#ae#rkung-Internet-Reichweite-Verbindung
RGB-Beleuchtung|Farbwechsel-LED-Individualisierung-Stimmungslicht
Externe Festplatte|Speicher-Daten-Backup-Transportabel-USB-Anschluss
Gaming-Tastatur|Spielen-Eingabeger#ae#t-Mechanische Tasten-Beleuchtung-Makrofunktionen
3D-Scanner|Objekterfassung-Digitalisierung-Modellierung-Punktewolke
USB-Adapter|Anschluss-Konverter-Erweiterung-Kompatibilit#ae#t
Over-Ear-Kopfh#oe#rer|Audio-Klangqualit#ae#t-Noise Cancelling-Komfort
NAS-System|Netzwerkspeicher-Datenzugriff-Dateiserver-Cloud-Synchronisation
Gaming-Stuhl|Sitzkomfort-Ergonomie-Verstellbarkeit-Lendenst#ue#tze
Grafikkarte|Bildverarbeitung-Gaming-Leistung-3D-Grafik
VPN|Sicherheit-Datenschutz-Netzwerk-Internetverschl#ue#sselung
USB-Mikrofon|Aufnahme-Gesang-Streaming-Podcast
In-Ear-Kopfh#oe#rer|Audio-Kompakt-Tragekomfort-Isolierung
RAID-System|Datenredundanz-Festplatten-Speicher-Backup
Gaming-Controller|Spielen-Steuerung-Konsolen-Gamepad-Pr#ae#zision
Power-over-Ethernet|Stromversorgung-Netzwerkkabel-Verbindung-POE
Ergonomische Maus|Komfort-Handgelenk-Pr#ae#vention-Design
WLAN-Adapter|Kabellos-Internet-Verbindung-USB-Dongle
Noise-Cancelling-Kopfh#oe#rer|Audio-Ger#ae#uschunterdr#ue#ckung-Stille-Fokussierung
Multiport-Adapter|Anschluss-Erweiterung-USB-HDMI-SD-Kartenleser
Gaming-Monitor|Spielen-Bildschirm-Reaktionszeit-Aufl#oe#sung-Fl#ue#ssige Darstellung
Dockingstation|Anschluss-Erweiterung-Laptop-Smartphone-Tablet
Gaming-Mauspad|Spielen-Pr#ae#zision-Oberfl#ae#che-Rutschfestigkeit
WLAN-Karte|Netzwerk-Internet-Verbindung-PCIe-Wireless
Webcam-Filter|Kamera-Objektiv-Filtereffekte-Fotografie
Ergonomische Tastatur|Komfort-Handgelenk-Layout-Design
Surround-Sound|Audio-Klangqualit#ae#t-R#ae#umliche Wahrnehmung-Immersives Erlebnis
NAS-Festplatte|Netzwerkspeicher-Datenzugriff-Backup-Speicherkapazit#ae#t
Gaming-PC|Spielen-Computer-Leistung-Grafik-Prozessor
USB-Stick mit Verschl#ue#sselung|Sicherheit-Daten-Transportabel-Verschl#ue#sselte Dateien
Powerline-Set|Netzwerk-Internet-Steckdose-Daten#ue#bertragung-Verbindung
Touchscreen-Monitor|Bildschirm-Ber#ue#hrung-Bedienung-Interaktion-Display
Esstisch|Esszimmer-M#oe#bel-Mahlzeiten-Treffen
Garderobe|Flur-Kleidung-Aufbewahrung-Haken
Schreibtisch|Arbeitsplatz-B#ue#ro-Studium-Schubladen
Sessel|Bequemlichkeit-Lesen-Entspannung-R#ue#ckenlehne
Kommode|Aufbewahrung-Schubladen-Kleidung-Ordnung
Regal|B#ue#cher-Dekoration-Aufbewahrung-Ordnung
K#ue#chentisch|Essen-Kochen-Gemeinschaft-Treffen
Stehlampe|Beleuchtung-Stehleuchte-Wohnzimmer-Design
Kleiderschrank|Kleidung-Aufbewahrung-Kleiderb#ue#gel-Kompartimente
Couchtisch|Wohnzimmer-Ablagefl#ae#che-Getr#ae#nke-Beistelltisch
Sideboard|Flur-Kommode-Aufbewahrung-Schrank
B#ue#cherregal|Lesen-Literatur-B#ue#cher-Organisation
Fernsehschrank|Unterhaltung-Medien-TV-Aufbewahrung
Badewanne|Entspannung-Entspannen-Wasser-Badezimmer
Beistelltisch|Ablage-Design-Klein-M#oe#belst#ue#ck
Nachttisch|Schlafzimmer-Ablage-Lampe-Nachtruhe
Spiegel|Reflexion-Badezimmer-Ankleiden-Dekoration
Kleiderst#ae#nder|Kleidung-Aufbewahrung-Haken-Platzsparend
Arbeitsstuhl|B#ue#ro-Komfort-Ergonomie-Drehbar
TV-St#ae#nder|Unterhaltung-Medien-Fernsehger#ae#t-Halterung
Programmiersprache|Code-Entwicklung-Compiler-Syntax-Algorithmen
Datenbank|Speicher-Daten-Abfragen-Tabellen-Informationen
Benutzeroberfl#ae#che|Interaktion-Design-Elemente-Nutzerfreundlichkeit
Versionierung|#AE#nderungen-Verlauf-Aktualisierung-Dokumentation
Cloud-Speicher|Daten-Online-Zugriff-Sicherheit-Synchronisation
Backup|Datensicherung-Wiederherstellung-Kopie-Speicherung
Textverarbeitung|Dokumente-Texte-Schreiben-Formatierung-Bearbeitung
Grafikdesign|Visuelle Kommunikation-Kreativit#ae#t-Layout-Bildbearbeitung
Videobearbeitung|Filme-Schnitt-Effekte-Rendering-Postproduktion
Antivirus|Sicherheit-Virenschutz-Malware-Scan
Browser|Internet-Webseiten-Surfen-Tab-Browsing
Virtuelle Realit#ae#t|Simulation-3D-Erlebnis-Interaktion-Brille
Projektmanagement|Planung-Organisation-Teamarbeit-Zeitplan
Datenanalyse|Informationen-Statistik-Auswertung-Erkenntnisse
Entwicklungsumgebung|Programmierung-Code-Entwicklung-Debugging
Netzwerktopologie|Verbindung-Kommunikation-Struktur-Router
Datenmigration|Transfer-Datenbank-Import-Export-Umzug
Bildbearbeitung|Fotos-Grafiken-Bearbeitung-Retusche-Effekte
Webhosting|Website-Server-Domain-Online-Speicherplatz
Texterkennung|OCR-Scannen-Dokumente-Zeichenerkennung
Datenkompression|Komprimierung-Platzsparen-Kodierung-Dekodierung
CAD-Software|Konstruktion-Design-Modellierung-Zeichnungen
Hochhaus|Wolkenkratzer-Etage-Aufzug-Architektur
Krankenhaus|Gesundheit-Medizin-Patienten-#AE#rzte-Operation
B#ue#rogeb#ae#ude|Arbeit-Arbeitsplatz-Kommunikation-Meeting-Kantine
Kirche|Glaube-Religion-Gottesdienst-Kreuz
Einkaufszentrum|Shopping-Gesch#ae#fte-Einkaufsm#oe#glichkeiten-Parkplatz
Fabrik|Produktion-Industrie-Arbeiter-Maschinen-Produkte
Bahnhof|Zug-Reisen-Gleise-Fahrkarten-Bahnsteig
Hotel|Unterkunft-#UE#bernachtung-Reisen-Zimmer-Service
Rathaus|Verwaltung-Kommune-Politik-B#ue#rgermeister
Museum|Kunstgeschichte-Ausstellung-Kunstwerke-Besucher
Bibliothek|B#ue#cher-Lesen-Studium-Wissen-Ausleihe
Stadion|Sport-Veranstaltung-Zuschauer-Fu#ss#ball-Arena
Flughafen|Reisen-Flugzeug-Abflug-Ankunft-Check-in
Gef#ae#ngnis|Strafe-Verbrechen-H#ae#ftlinge-Sicherheit
Parkhaus|Auto-Parken-Stellplatz-Mehrstock-Parkplatz
Opernhaus|Musik-Klassik-Oper-B#ue#hne-Darstellung
Wohnhaus|Wohnen-Familie-Leben-Nachbarn
Lagerhalle|Lagerung-Waren-Logistik-Versand
Universit#ae#tsgeb#ae#ude|H#oe#rsaal-Campus-Studium-Vorlesung-Fakult#ae#t
Fabrikgeb#ae#ude|Produktion-Industrie-Maschinen-Produkte
Turnhalle|Sport-Fitness-Training-#UE#bungen
Bauernhof|Tiere-Landwirtschaft-Feld-Tiere-Milch
Herrenhaus|Adel-Geschichte-Garten-Anwesen
Markthalle|Essen-St#ae#nde-Lebensmittel-Handel-Frische
Lagerhaus|Lagerung-Waren-Logistik-Inventar
Kindergarten|Kinder-Betreuung-Spielzeug-Spielen
Wohnkomplex|Wohnanlage-Mehrfamilienhaus-Wohnungen-Nachbarschaft
Kunsthalle|Ausstellung-Kunst-K#ue#nstler-Besucher
Industriepark|Produktion-Industrie-Fabriken-Arbeitspl#ae#tze
Regierungsgeb#ae#ude|Politik-Verwaltung-Politiker-B#ue#ro
Sportstadion|Veranstaltung-Sportarten-Zuschauer-Stadion
Mietshaus|Wohnungen-Mieter-Mietvertrag-Verwaltung
Jugendherberge|Unterkunft-Reisen-Jugendliche-Gemeinschaftsraum
Skigebiet|Wintersport-Pisten-Skifahren-Snowboarden
Klassenzimmer|Lehrer-Sch#ue#ler-Tafel-Schreibtisch-Lernen
Lehrer|Unterricht-Bildung-P#ae#dagoge-Wissen-Sch#ue#ler
Sch#ue#ler|Lernen-Bildung-Schule-Klassenkameraden-Noten
Stundenplan|Unterrichtszeiten-F#ae#cher-Plan-Schulalltag
Schulranzen|Schultasche-B#ue#cher-Hausaufgaben-Schulmaterial
Pausenhof|Pause-Spielen-Freunde-Entspannung
Schulhof|Spielen-Treffen-Pause-Sport
Sportunterricht|Bewegung-Sportarten-Training-Koordination
Schult#ue#te|Einschulung-S#ue##ss#igkeiten-#UE#berraschung-Geschenk
Schulbuch|Lernen-Unterricht-Bildung-Wissen
Schuluniform|Kleidung-Sch#ue#ler-Regeln-Identifikation
Klassenarbeit|Pr#ue#fung-Test-Noten-Vorbereitung
Schulgarten|Pflanzen-Natur-Umwelt-Biologie
Schulferien|Pause-Erholung-Freizeit-Sch#ue#ler
Schulprojekt|Gruppenarbeit-Pr#ae#sentation-Thema-Kreativit#ae#t
Schulchor|Musik-Singen-Auftritte-Konzerte
Schulsport|Sportarten-Training-Wettbewerb-Team
Schulparty|Feiern-Veranstaltung-Sch#ue#ler-Treffen-Tanz
Schulbibliothek|B#ue#cher-Lesen-Recherche-Lernressourcen
Sch#ue#lerausweis|Identifikation-Schule-Berechtigungen
Schulschw#ae#nzen|Unterricht-Fehlen-Konsequenzen-Verantwortung
Schulabschluss|Abitur-Abschlussfeier-Zeugnis-Zukunft
Schulkantine|Mittagessen-Essen-Pausenverpflegung
Schulkonzert|Musik-Auftritte-Vorf#ue#hrung-K#ue#nstler
Sch#ue#leraustausch|Internationale-Begegnung-Kultur-Austausch
Schulleiter|Leitung-Schulalltag-Verwaltung-Lehrer
Schulweg|Weg-Strecke-Sicherheit-Sch#ue#ler
Schulkreide|Tafel-Schreiben-Unterricht-Lehrer
Vorlesung|Studium-Dozent-Wissen-H#oe#rsaal-Studenten
Student|Studium-Hochschule-Bachelor-Master-Kommilitone
Pr#ue#fung|Klausur-Test-Noten-Vorbereitung
Campus|Hochschule-Studenten-Leben-Gel#ae#nde
Mensa|Essen-Kantine-Studenten-Mahlzeiten
Professor|Lehre-Fachbereich-Dozent-Vorlesung
Seminar|Studium-Diskussion-Gruppenarbeit-Vortrag
Fachbereich|Studium-Abteilung-Fakult#ae#t-Disziplin
Wohnheim|Studenten-Wohnen-Zimmer-Mitbewohner
Labor|Forschung-Experimente-Chemie-Biologie
Studiengeb#ue#hren|Kosten-Hochschule-Bezahlung-Finanzierung
Studentenwohnung|Wohnen-Zimmer-Miete-K#ue#che-Bad
Tutor|Hilfe-Unterst#ue#tzung-Studium-Studenten
Studentenausweis|Identifikation-Hochschule-Berechtigungen
Auslandssemester|Studium-Ausland-Erfahrung-Kultur
Klausur|Pr#ue#fung-Test-Noten-Vorbereitung
Dozent|Lehre-Professor-Vorlesung-Hochschule
Lerngruppe|Studium-Gemeinschaft-Lernen-Austausch
Campusleben|Studenten-Aktivit#ae#ten-Veranstaltungen-Sozial
Masterstudium|Studium-Abschluss-Master-Diplom
Studentenverein|Gemeinschaft-Interessen-Veranstaltungen-Engagement
Studentenjob|Arbeit-Nebenjob-Verdienst-Studium
Seminarraum|Studium-Diskussion-Vortrag-Raum
Vorlesungssaal|Studium-H#oe#rsaal-Vorlesung-Dozent
Studentenverbindung|Gemeinschaft-Tradition-Feste-Kontakte
Studienberatung|Unterst#ue#tzung-Beratung-Studium-Entscheidungen
Studiengang|Studium-Fachrichtung-Modul-Pr#ue#fungen
Studentenwohnheim|Wohnen-Zimmer-Mitbewohner-Gemeinschaft
Laboratorium|Forschung-Experimente-Wissenschaft-Chemie
Tutorium|Unterst#ue#tzung-Studium-Hilfe-Kommilitone
Wohnheimzimmer|Studenten-Wohnen-Zimmer-Mitbewohner
Hochschulbibliothek|Studium-Lesen-Recherche-Lernressourcen
Bildschirm|Monitor-Anzeige-Display-Bild
Hardware|Komponenten-Ger#ae#te-Technologie-Peripherie
Internet|Netzwerk-Verbindung-Online-Web
Daten|Informationen-Speicherung-Dateien-Digital
Speicher|Festplatte-RAM-Datenspeicherung-Kapazit#ae#t
Programmierung|Code-Entwicklung-Programmiersprachen-Algorithmen
Datei|Dokument-Speicherung-Ordner-Informationen
Virus|Malware-Schadsoftware-Sicherheit-Infektion
Prozessor|CPU-Leistung-Geschwindigkeit-Berechnungen
Gaming|Spiele-Videospiel-Unterhaltung-Online
Softwareentwicklung|Programmierung-Entwicklung-Code-Programme
Dateiformat|Dokument-Informationen-Endung-Format
IT|Informationstechnologie-Computer-Technik-Netzwerke
Multimedia|Medien-Audio-Video-Unterhaltung
Hardwarekomponenten|Ger#ae#te-Komponenten-Technologie-Peripherie
Benutzerkonto|Anmeldung-Zugriff-Kennwort-Passwort
Computervirus|Malware-Schadsoftware-Infektion-Sicherheit
Softwareaktualisierung|Update-Programm-Aktualisierung-Funktionen
Dateimanager|Verwaltung-Ordner-Dateien-Zugriff
Innovation|Fortschritt-Entwicklung-Neuheit-Technologie
Maschine|Ger#ae#t-Produktion-Mechanik-Technologie
Ingenieur|Beruf-Technologie-Entwicklung-Konstruktion
Automation|Automatisierung-Prozesse-Maschinen-Industrie
Elektrizit#ae#t|Energie-Strom-Spannung-Verbrauch
Mechanik|Physik-Kraft-Bewegung-Maschinen
Telekommunikation|Kommunikation-Technologie-Mobilfunk-Internet
Energie|Strom-Quelle-Nachhaltigkeit-Ressourcen
Digitalisierung|Technologie-Transformation-Daten-Digital
Automobil|Fahrzeug-Transport-Technologie-Mobilit#ae#t
Raumfahrt|Weltraum-Technologie-Forschung-Exploration
Erneuerbare Energien|Nachhaltigkeit-Umwelt-Energiequelle-Wind-Sonne
3D-Druck|Technologie-Herstellung-Prototypen-Design
Informationstechnologie|IT-Computer-Netzwerke-Software
Automatisierungstechnik|Prozesse-Produktion-Steuerung-Industrie
Elektrotechnik|Strom-Elektronik-Schaltungen-Technologie
Biotechnologie|Forschung-Gentechnik-Medizin-Lebensmittel
Medizintechnik|Gesundheit-Medizin-Ger#ae#te-Technologie
Nachhaltigkeit|Umwelt-Ressourcen-Energie-Naturschutz
Luftfahrt|Flugzeug-Technologie-Luftfahrtindustrie
Industrietechnik|Produktion-Fertigung-Maschinen-Industrie
Informationssicherheit|Datenschutz-Sicherheit-IT-Netzwerke
Technologieunternehmen|Unternehmen-Innovation-Technik-Industrie
Ingenieurwesen|Technologie-Konstruktion-Entwicklung-Planung
Satellit|Weltraum-Kommunikation-Technologie-Erdbeobachtung
Funktechnik|Kommunikation-#UE#bertragung-Signale-Technologie
Industrie 4.0|Digitalisierung-Produktion-Technologie-Ver#ae#nderung
Automatisierte Fahrzeuge|Autonome-Fahrzeuge-Technologie-Transport
M#oe#bel|Einrichtungsgegenst#ae#nde-Einrichten-Einrichtungsstil
Dekoration|Gestaltung-Raum-Akzente-Stil
Interieur|Innenausstattung-Raumgestaltung-Einrichtungsstil
Wohnzimmer|Raum-Sitzm#oe#bel-Fernseher-Gem#ue#tlichkeit
Schlafzimmer|Raum-Bett-Nachtruhe-Entspannung
K#ue#che|Raum-Essen-Kochen-Ger#ae#te
Einrichtungsgegenst#ae#nde|M#oe#bel-Dekoration-Gegenst#ae#nde-Raumgestaltung
Beleuchtung|Licht-Atmosph#ae#re-Stimmung-Helligkeit
Stil|Design-Trends-Pers#oe#nlichkeit-Einzigartigkeit
Farben|Gestaltung-#AE#sthetik-Akzente-Farbwahl
Wohnaccessoires|Dekoration-Einrichtungsgegenst#ae#nde-Raumgestaltung
Raumplanung|Gestaltung-Einrichtung-Raumaufteilung-Optimierung
Esszimmer|Raum-Essen-Tisch-St#ue#hle
Arbeitszimmer|Raum-Arbeiten-Schreibtisch-Konzentration
Wohnstil|Einrichtungsstil-Design-Geschmack-Trends
Wohnraum|Zimmer-Einrichtung-Gem#ue#tlichkeit-Design
Minimalismus|Reduktion-Einfachheit-Klarheit-Stil
Vintage|Retro-Antik-Nostalgie-Einzigartigkeit
Skandinavisch|Nordisch-Design-Helligkeit-Gem#ue#tlichkeit
Landhausstil|L#ae#ndlich-Rustikal-Naturverbundenheit-Gem#ue#tlichkeit
Modern|Zeitgem#ae##ss#-Design-Trends-Funktionalit#ae#t
Industrial|Fabrik-Stil-Rohmaterialien-Authentizit#ae#t
Feng Shui|Energie-Harmonie-Raumgestaltung-Balance
Wohnkonzept|Gestaltung-Konzept-Raum-Einzigartigkeit
Haustier|Tierart-Haltung-Gef#ae#hrte-Pflege
Fische|Aquarium-Wasser-Tropisch-Schwimmen
Kaninchen|Nagetier-Hasenstall-Springen-Karotte
Hamster|Nagetier-Laufrad-Streu-Spielen
Meerschweinchen|Nagetier-Heu-Quieken-Streicheln
Tierheim|Tierschutz-Adoption-Vermittlung-Pflege
Wildtiere|Natur-#OE#kosystem-Artenschutz-Lebensraum
Exoten|Fremdartig-Seltenheit-Au#ss#ergew#oe#hnlich-Artenvielfalt
Reptilien|Echsen-Schlangen-Terrarium-H#ae#utung
Insekten|K#ae#fer-Schmetterling-Spinnen-Kriechtiere
Tierarzt|Gesundheit-Pflege-Behandlung-Krankheiten
Tierfutter|Nahrung-F#ue#tterung-Ern#ae#hrung-Leckerlis
Tierpflege|Pflege-Hygiene-Sauberkeit-Wohlbefinden
Tierkommunikation|Verst#ae#ndigung-Sprache-Beziehung-Tiertrainer
Tierrecht|Tierschutz-Tierethik-Verantwortung-Gesetz
Tierpsychologie|Verhalten-Tierverhalten-Kommunikation-Training
Zoologie|Tierwissenschaft-Forschung-Tierarten-Evolution
Tierliebe|Zuneigung-Verbundenheit-Emotionen-Beziehung
Tierhaltung|Haustier-Pflege-Verantwortung-Gef#ae#hrte
Tiergehege|Gehege-Zoo-Freigehege-Tierpark
Tierfamilie|Nachwuchs-Jungtiere-Eltern-Pflege
Tierverhalten|Verhaltensweise-Kommunikation-Sozialverhalten-Evolution
Tierausstellung|Show-Wettbewerb-Rassen-Tierzucht
Tiermotive|Motiv-Darstellung-Kunst-Design
Tierpr#ae#paration|Pr#ae#parat-Museum-Pr#ae#parator-Konservierung
K#ue#ste|Meeresrand-Strand-Land-Wasser
Meeresbewohner|Lebewesen-Tiere-Fische-#OE#kosystem
Korallenriff|Riff-Tauchen-Meereslebewesen-#OE#kosystem
Meeresverschmutzung|Umweltverschmutzung-Plastikm#ue#ll-Verschmutzung-#OE#kosystem
Segeln|Bootsport-Wasser-Wind-Abenteuer
Wellen|Wasser-Bewegung-Brandung-Surfen
Unterwasserwelt|Meereslebewesen-Tauchen-Erkundung-Faszination
K#ue#stenlandschaft|Natur-Meer-Felsen-Strand
Fischerei|Fangen-Fische-Meeresfr#ue#chte-Nachhaltigkeit
Meeresboden|Boden-Meereslebewesen-Unterwasser-Sedimente
Meeresstr#oe#mung|Str#oe#mung-Wasser-Ozean-Tiefsee
Seestern|Meereslebewesen-Tier-Ozean-Unterwasser
Haie|Meereslebewesen-Raubtier-Fisch-Flossen
Delfine|Meereslebewesen-Tier-Ozean-S#ae#ugetier
Wale|Meereslebewesen-Tier-Ozean-S#ae#ugetier
Muscheln|Meereslebewesen-Schalen-Ozean-Strand
Tauchen|Unterwasser-Erkundung-Sport-Atmen
Seegras|Pflanze-Meer-#OE#kosystem-Ufer
Meeresbrise|Wind-K#ue#ste-Erfrischung-Urlaub
Gezeiten|Mond-Wasser-Meer-K#ue#ste
Seemann|Schiff-Kapit#ae#n-See-Abenteuer
K#ue#stentiere|Lebewesen-Strand-Tiere-Wasser
Meeresforschung|Forschung-Wissenschaft-Ozean-Lebewesen
Wrack|Schiff-Untergang-Unterwasser-Entdeckung
Meeresbiologie|Wissenschaft-Lebewesen-Ozean-Tiere
Muschelschalen|Strand-Funde-Entdeckung-Sammlung
Meeresrauschen|Wellen-K#ue#ste-Entspannung-Urlaub
Fischschwarm|Fische-Meereslebewesen-Schwarm-Unterwasser
Strandurlaub|K#ue#ste-Sand-Meer-Erholung
Meerestiere|Tiere-Meereslebewesen-Ozean-Unterwasser
Tiefsee|Ozean-Unterwasser-Lebewesen-Erkundung
Meereslandschaft|Natur-K#ue#ste-Weite-Meer
Meeresfr#ue#chte|Fische-Krustentiere-Delikatesse-K#ue#che
Seesterne|Meereslebewesen-Tiere-Unterwasser-Ozean
Ozeanographie|Wissenschaft-Forschung-Ozean-Lebensraum
Seetang|Algen-Meereslebewesen-Unterwasser-Nahrung
Meeres#oe#kologie|#OE#kosystem-Natur-Lebewesen-Meereslebewesen
Brandung|Wellen-K#ue#ste-Meer-Surfen
Meeresraubtiere|Tiere-Raubtier-Ozean-Beute
Muschelsuche|Strand-Funde-Entdeckung-Sammlung
K#ue#stenschutz|Schutz-Naturschutz-K#ue#ste-Meer
Meeresluft|Salzluft-K#ue#ste-Erfrischung-Urlaub
Umwelt|Natur-#OE#kosystem-Nachhaltigkeit-#OE#kologie
Berge|Gebirge-Natur-Wandern-Aussicht
Fluss|Gew#ae#sser-Wasser-Natur-Landschaft
Pflanzen|Natur-Gew#ae#chse-Blumen-Photosynthese
Tierwelt|Tiere-Natur-Lebensraum-Artenvielfalt
Landschaft|Natur-Szenerie-Aussicht-Panorama
Nationalpark|Schutzgebiet-Natur-Tiere-Erholung
B#ae#ume|Natur-Wald-Pflanzen-Sauerstoff
W#ue#ste|Trockenheit-Sand-Hitze-#OE#kosystem
Seen|Gew#ae#sser-Wasser-Natur-Erholung
Oase|W#ue#ste-Natur-Pflanzen-Wasserquelle
Blumen|Pflanzen-Natur-Duft-Farbenpracht
Naturwissenschaft|Wissenschaft-Forschung-Natur-Umwelt
Tropischer Regenwald|Regenwald-Natur-Pflanzen-Tiere
Felsen|Steine-Natur-Berge-Gestein
Naturpfad|Wandern-Spaziergang-Naturerlebnis-Aktivit#ae#t
Naturschutz|Umweltschutz-Erhaltung-Natur-Lebensraum
Biodiversit#ae#t|Artenvielfalt-Natur-Lebensraum-#OE#kosystem
Wasserfall|Flie#ss#en-Natur-Ger#ae#usch-Bezaubernd
Landschaftsfotografie|Fotografie-Natur-Aufnahme-Panorama
Outdoor-Aktivit#ae#ten|Aktivit#ae#ten-Natur-Freizeit-Erlebnis
Naturerlebnis|Erleben-Entdecken-Natur-Sinne
Botanischer Garten|Garten-Pflanzen-Natur-Erholung
Flora und Fauna|Pflanzen-Tiere-Natur-Lebensraum
Natursch#oe#nheit|Sch#oe#nheit-Natur-Landschaft-Magie
Tierbeobachtung|Beobachten-Natur-Tiere-Verhalten
Naturkatastrophe|Katastrophe-Umwelt-Natur-Ereignis
Naturparks|Parks-Natur-Erholung-Tiere
Naturverbundenheit|Verbindung-Natur-Umwelt-Spiritualit#ae#t
Naturreservat|Schutzgebiet-Natur-Tiere-Erhaltung
Naturliebhaber|Liebe-Natur-Begeisterung-Erkundung
Naturfotografie|Fotografie-Natur-Landschaft-Tiere
Naturschutzgebiet|Schutzgebiet-Natur-Tiere-Lebensraum
Naturwunder|Wunder-Natur-Beeindruckend-Einzigartig
Naturheilkunde|Heilkunde-Heilung-Natur-Gesundheit
Naturschutzorganisation|Organisation-Schutz-Natur-Umwelt
Naturerhaltung|Erhaltung-Schutz-Natur-Umwelt
Naturlandschaft|Landschaft-Natur-Sch#oe#nheit-Aussicht
Landwirtschaft|Bauernhof-Feld-Tiere-Ernte
L#ae#ndliche Region|Dorf-Natur-Ruhe-Tradition
Fl#ae#che|Gebiet-Land-Ausdehnung-Gr#oe##ss#e
Landmarken|Wahrzeichen-Sehensw#ue#rdigkeiten-Kultur-Geschichte
Landeshauptstadt|Stadt-Regierung-Politik-Verwaltung
Dorf|Kleinstadt-Land-Natur-Gemeinschaft
Ackerland|Feld-Pflanzen-Landwirtschaft-Anbau
W#ae#lder|Natur-B#ae#ume-Wildnis-Wanderung
Wiesen|Natur-Gras-Blumen-Weite
Stadt|Urban-Leben-Geb#ae#ude-Kultur
Bev#oe#lkerung|Einwohner-Einheimische-Menschen-Demografie
Kultur|Tradition-Brauchtum-Kunst-Lebensweise
Landesgrenzen|Grenzen-Staat-Territorium-Gebiet
Tourismus|Reisen-Erkunden-Besichtigung-Erholung
Geschichte|Vergangenheit-Vergangenheitsbew#ae#ltigung-Kultur-Ereignisse
Natur|Umwelt-#OE#kosystem-Landschaft-Pflanzen
Infrastruktur|Verkehr-Kommunikation-Netzwerke-Entwicklung
Landeshymne|Hymne-Nationalhymne-Staat-Land
Landschaftsschutz|Schutz-Natur-Umwelt-Landschaft
Kulturlandschaft|Natur-Kultur-Landschaft-Tradition
Landesregierung|Regierung-Politik-Verwaltung-Land
L#ae#ndliches Leben|Dorf-Natur-Gemeinschaft-Tradition
Landbev#oe#lkerung|Einwohner-Dorf-Natur-Gemeinschaft
Landflucht|Migration-Stadt-Landwirtschaft-Urbanisierung
Agrarwirtschaft|Landwirtschaft-Land-Bauern-Lebensmittel
Landbesitz|Besitz-Grundst#ue#ck-Immobilien-Eigentum
Landschaftsmalerei|Malerei-Natur-Kunst-Landschaft
Landesw#ae#hrung|W#ae#hrung-Geld-Land-Bezahlung
Landessprache|Sprache-Kommunikation-Land-Kultur
L#ae#ndliche Entwicklung|Entwicklung-Dorf-Natur-Infrastruktur
Landwirtschaftliche Betriebe|Betriebe-Bauernhof-Landwirtschaft-Ernte
L#ae#ndlicher Tourismus|Tourismus-Dorf-Natur-Erholung
Landstriche|Gebiet-Region-Landschaft-Grenzen
Landesflagge|Flagge-Symbol-Staat-Land
Landesgesetze|Gesetze-Regeln-Land-Recht
Landbeschaffung|Beschaffung-Erwerb-Grundst#ue#ck-Immobilien
Landessitten|Sitten-Br#ae#uche-Traditionen-Kultur
Unternehmen|Firma-Wirtschaft-Gesch#ae#ft-Arbeit
Finanzen|Geld-Wirtschaft-Finanzen-Investment
Wachstum|Entwicklung-Wirtschaft-Fortschritt-Erweiterung
Arbeitsmarkt|Arbeit-Jobs-Besch#ae#ftigung-Karriere
B#oe#rse|Aktien-M#ae#rkte-Wirtschaft-Finanzwesen
Industrie|Produktion-Fabrik-Wirtschaft-Gewerbe
Handel|Gesch#ae#ft-Wirtschaft-Kauf-Verkauf
Technologie|Innovation-Digitalisierung-Wirtschaft-Fortschritt
Globalisierung|Internationalisierung-Wirtschaft-Integration-Welt
Arbeitsplatz|Job-Besch#ae#ftigung-Karriere-Arbeit
Investition|Geld-Anlage-Wirtschaft-Finanzen
Export|Ausfuhr-Handel-Wirtschaft-L#ae#nder
Import|Einfuhr-Handel-Wirtschaft-L#ae#nder
Wirtschaftswachstum|Wachstum-Wirtschaft-Entwicklung-Fortschritt
Konjunktur|Wirtschaftslage-Konjunkturzyklus-Krise-Aufschwung
Inflation|Preisanstieg-Wirtschaft-Geld-Wertverlust
Dienstleistungen|Service-Wirtschaft-Serviceleistung-Servicebranche
Unternehmensgr#ue#ndung|Gr#ue#ndung-Start-up-Unternehmen-Wirtschaft
Marktwirtschaft|Wirtschaftssystem-Wettbewerb-Freihandel
Arbeitslosigkeit|Arbeit-Wirtschaft-Jobs-Arbeitsmarkt
Wirtschaftspolitik|Politik-Wirtschaft-Staat-Entscheidungen
Wirtschaftsforschung|Forschung-Wissenschaft-Wirtschaft-Entwicklung
Branchen|Industrien-Wirtschaft-Sektoren-Gesch#ae#ftsbereiche
Wirtschaftsrecht|Recht-Wirtschaft-Regelungen-Gesetze
Wirtschaftsleistung|Leistung-Wirtschaft-Produktion-Indikator
Steuern|Staat-Finanzen-Wirtschaft-Abgaben
Handelsbeziehungen|Beziehungen-Wirtschaft-Handel-International
Unternehmenskultur|Kultur-Wirtschaft-Unternehmen-Mitarbeiter
Wirtschaftsnachrichten|Nachrichten-Wirtschaft-Wirtschaftsentwicklung-Aktuelles
Wirtschaftsfaktoren|Faktoren-Wirtschaft-Entwicklung-Einfluss
Patent|Schutzrecht-Genehmigung-Erfinder-Neuheit-Innovation
Mikrowelle|Kochen-Erw#ae#rmung-Ger#ae#t-Haushalt-Elektrisch
Telefonzelle|Kommunikation-#OE#ffentlich-Telefon-Anruf-Zelle
Schreibmaschine|Schreiben-B#ue#ro-Tastatur-Text-Mechanisch
MP3-Player|Musik-Portable-Ger#ae#t-Audio-Dateiformat
Videokonferenz|Kommunikation-Online-Video-Meeting-Distanz
Dampfmaschine|Energie-Dampf-Industrie-Dampfkraft-James Watt
Segway|Transport-Fortbewegung-Ger#ae#t-Elektrisch-Personenbef#oe#rderung
Walkman|Musik-Portable-Kassette-Ger#ae#t-Sony
Taschenrechner|Berechnung-Mathematik-Ger#ae#t-Addition-Subtraktion
Videospiele|Unterhaltung-Spiel-Controller-Konsole-Grafik
Barcode|Kennzeichnung-Scanner-Produkt-Strichcode-Identifikation
Medikament|Arzneimittel-Gesundheit-Heilung-Pharmazie-Wirkstoff
Rolltreppe|Transport-Vertikal-Escalator-Aufzug-Stufen
Solarzelle|Energie-Sonnenlicht-Strom-Photovoltaik-Photovoltaikanlage
Herzschrittmacher|Medizin-Herz-Gesundheit-Implantat-Rhythmus
Videokamera|Aufnahme-Film-Bild-Speicherung-Objektiv
Laser|Licht-Technologie-Strahl-Photon-Optik
Walkie-Talkie|Kommunikation-Funkger#ae#t-Drahtlos-Ger#ae#t-Handheld
Plattenspieler|Musik-Tontr#ae#ger-Vinyl-Grammophon-Schallplatte
|