Mittagessen|Fr#ue#hst#ue#ck-Abend-Pause-Bauch-schnell
Entf#ue#rung|Geisel-Mensch-rauben-Kidnapper-Geld
Duty Free|Zoll-Geb#ue#hr-kaufen-Preis-Flughafen
Pickel|Haut-Entz#ue#ndung-Eiter-Gesicht-Akne
Chaos|Durcheinander-Unordnung-Verwirrung-Theorie-Regel
Kitzeln|ber#ue#hren-anfassen-kichern-lachen-Rippen
Brechbohnen|Gem#ue#se-gr#ue#n-essen-gesund-#ue#bergeben
Orbit|Bahn-Erde-Planet-Kreis-Satellit
Zugspitze|Berg-hoch-Bahn-oben-Nadel
Cool|l#ae#ssig-entspannt-locker-Eis-kalt
Stecker|Strom-Kabel-Dose-Ger#ae#tElektrizit#ae#t
Hologramm|Bild-Licht-3D-Raum-Foto
Pflaster|Wunde-Blut-kleben-Schutz-Stra#ss#e
Ruhm|Star-Promi-Ansehen-besonders-Erfolg
Schimmel|alt-blau-Pilz-K#ae#se-Pferd
Milch|Kuh-trinken-wei#ss#-melken-Kind
Freiklettern|Sport-extrem-Berg-Seil-Schutz
W#ue#ste|Sand-trocken-hei#ss#-Sahara-Gobi
Faulpelz|tr#ae#ge-m#ue#de-nichts-machen-ausruhen
Youtube|Video-Film-Clip-Klick-Internet
Knete|Masse-weiche-basteln-Form-Geld
Butter|Fett-Milch-Rahm-Brot-streichen
Party|feiern-G#ae#ste-Geburtstag-Einladung-Musik
Positiv|Plus-ja-gut-denken-negativ-Corona-Blut
Mond|Nacht-Himmel-Sonne-Sterne-Sichel
Uhr|Zeit-Stunde-Minute-Zeiger-Zahl-Arm-Hand
Pantomime|Schauspieler-B#ue#hne-stumm-Zeichen-wei#ss#
Vampier|Blut-saugen-Dracula-Z#ae#hne-Fledermaus
Tierarzt|Doktor-krank-impfen-Hund-Katze
Folienkartoffel|essen-hei#ss#-Ofen-Schale-Butter
Schlagzeile|zeitung-#ue#berschrift-gro#ss#-Buchstaben-wichtig
Raumstation|Weltall-Erde-Rakete-Shuttle-Forschung
Wurm|Tier-Erde-Boden-weich-Regen
Wohnmobil|Auto-gro#ss#-schlafen-Urlaub-Ferien
Wii|Konsole-spielen-Nintendo-Video-Controller
Stinken|riechen-schlecht-Nase-Schwei#ss#-Socken-Geruch
Alien|Wesen-Kreatur-E.T.-Weltall-au#ss#erirdisch
Krankenschwester|Pfleger-Frau-Art-Beruf-helfen
Speed-Dating|flirten-schnell-treffen-kennlernen-Partner
Hobbit|Herr der Ringe-klein-Beutlin-Bibo-Film
Joker|Karte-Spiel-Ersatz-tauschen-Narr
Ger#ue#cht|reden-tratschen-Leute-Wahrheit-Vermutung
Ratenkauf|neu-bezahlen-Monat-Summe-Zinsen
Eingang|rein-T#ue#r-Haus-laufen-Ausgang
Flugbegleiter|Reise-Urlaub-sitzen-Stewardess-Getr#ae#nke
Bew#ae#hrungshelfer|Strafe-Gef#ae#ngnis-Gericht-danach-Leben
M#ue#cke|Insekt-fliegen-stechen-Sommer-Moskito
Zeitmaschine|Ger#ae#t-reisen-Zukunft-Vergangenheit.Uhr
Rapunzel|M#ae#rchen-Haare-lang-Turm-Prinz
Dip|essen-So#ss#e-Chips-karotten-tauchen
Pizza|essen-Italien-Ofen-Teil-Margarita
Blockbuster|Kino-Film-Hit-Zuschauer-viele
Gef#ae#ngnis|verhaftet-Strafe-Gitter-Knast-sitzen
Armband|Hand-Gelenk-Schmuck-Perlen-Uhr
Las Vegas|Stadt-Amerika-spielen-Casino-Gl#ue#ck
Pommes|frittiert-essen-Kartoffeln-St#ae#bchen-Ketchup
Rezept|Anleitung-Zutaten-kochen-backen-Aphotheke
Omelett|essen-Ei-Pfanne-backen-Schinken
Date|Verabredung-treffen-blind-verliebt-Zeit
Palme|Pflanze-F#ae#cher-Wedel-Strand-Kokosnuss
Muffin|Kuchen-klein-s#ue##ss#-backen-Form
Yoga|#ue#bung-Kurs-dehnen-meditieren-entspannen
Meerjungfrau|M#ae#dchen-Wasser-Fisch-H#ae#lfte-Bein
Rei#ss#verschluss|Jacke-Hose-Metall-ziehen-Z#ae#hne
Meer|Wasser-See-gro#ss#-Ozean-Mitte
K#ae#fer|Insekt-krabbeln-Hirsch-Gl#ue#ck-Auto
Leiter|Stufen-hoch-klettern-Wand-anlehnen
Knospe|Blume-bl#ue#hen-geschlossen-#oe#ffnen-wachsen
Tropfen|Wasser-fl#ue#ssig-klein-dicht-Stein
Zapping|Fernsehr-Bedienung-umschalten-Programm-Kanal
Sushi|essen-Fisch-Reis-roh-Japan
SUV|Auto-Wagen-Gel#ae#nde-Kombi-gro#ss#
Rasenm#ae#her|Garten-Gras-schneiden-Boden-Motor
Code|geheim-Zahl-Nummer-Wort-eingeben
Mitternacht|Zeit-zw#oe#lf-Uhr-Stunde-Geister
Elektrizit#ae#t|Strom-Werk-Steckdose-Energie-Licht
Alligator|Krokodil-Reptil-Sumpf-Z#ae#hne-Tier
Geschirrsp#ue#ler|Maschine-K#ue#che-waschen-sauber-Teller
Popcorn|Snack-Mais-platzen-Salz-Kino
Flughafen|Reise-Urlaub-Rollfeld-Start-Landung
Windows|Computer-PC-Programm-System-Fenster
Anchovis|Fisch-Sardelle-Pizza-salzig-klein
Zaunk#oe#nig|Vogel-Garten-Grundst#ue#ck-Latten-Krone
Plattensee|Wasser-gro#ss#-flach-Balaton-Ungarn
Querfl#oe#te|Musik-Instrument-spielen-blasen-Block
Eifelturm|#ue#aris-Frankreich-Wahrzeichen-hoch-Eisen
Partnerlook|zwei-Paar-Kleidung-gleich-aussehen
Croissant|B#ae#cker-H#oe#rnchen-Frankreich-essen-knusprig
Nebelwand|Dunst-Dampf-Regen-d#ue#ster-Mauer
Wasserfall|Fluss-steil-st#ue#rzen-herab-Niagara
Ernte|Herbst-Feld-Getreide-Obst-pfl#ue#cken-Bauer
Ofen|K#ue#che-backen-Herd-hei#ss#-Umluft
Pleite|Geld-keins-leer-blank-Geier
Antik|alt-Geschichte-fr#ue#her-Zeit-M#oe#bel
Hype|neu-Thema-Medien-toll-Begeisterung
Schwimmweste|retten-Not-Meer-ertrinken-Schiff
Sonnenblume|gro#ss#-gelb-bl#ue#hen-Feld-Kern
Vulkan|Berg-Lava-hei#ss#-Erde-Ausbruch
Gala|Fest-Empfang-Promis-Spenden-Zeischrift
Fingerabdruck|Hand-f#ue#nf-Haut-Muster-einmalig
Held|Retter-Stark-Action-Ironman-Spiderman
Kreide|malen-schreiben-Tafel-Stra#ss#e-wei#ss#
Moor|Natur-Gebiet-feucht-Schlamm-versinken
Ballermann|Mallorca-Urlaub-Party-feiern-saufen
Besen|kehren-Schaufel-Stiel-Boden-fliegen
Laser|Strahl-Licht-schie#ss#en-schneiden-zerlegen
Verkehrsinfarkt|Stra#ss#e-Auto-viel-Stau-Herz
Schlecht|b#oe#se-#ue#bel-negativ-falsch-gut
Peeling|Haut-Schuppen-l#oe#sen-glatt-weich
Anker|Schiff-Haken-halten-setzen-lichten
Cycling|Rad-fahren-Studio-drinnen-Fitness
Ader|K#oe#rper-Blut-Herz-flie#ss#en-Vene
Karaoke|Musik-singen-Mikrofon-Bar-Lied-trinken
Reich|arm-Geld-viel-Million#ae#r-Luxus
Schwitzkasten|k#ae#mpfen-ringen-Kopf-halten-Sauna
Mascara|Wimpern-Tusche-Auge-schminken-schwarz
Asche|Feuer-brennen-Holz-#ue#brig-Kamin
Taschendieb|Hand-Finger-heimlich-stehlen-Geld
Jackpot|Lotto-Spiel-Gl#ue#ck-knacken-gewinnen
Allergie|Reaktion-Abwehr-Ausschlag-Nase-Haut
Komma|Punkt-Satz-Zeichen-Wort-trennen
Schatz|Gold-Kiste-Versteck-suchen-Liebling
Blu-Ray|DVD-Scheibe-Player-Film-Video-Blau-Rot
Gummi|kauen-Reifen-Ente-radieren-weich
Arena|Stadion-Sport-Fu#ss#ball-Konzert-Publikum
R#ue#ckrunde|Sport-Turnier-Spiel-Rang-wieder
L#oe#wenzahn|Pflanze-gr#ue#n-Gras-Tier-pusten
Hinterm Horizont|Musical-Theater-Berlin-Lindenberg-Mauer
Achilles|Grieche-Held-Sage-Ferse-Troja-gegenteil-Fu#ss#
Schuhplattler|Musik-Tanz-Fu#ss#-klatschen-Lederhose
DVD|Scheibe-Film-Fernsehr-Player-Bluray
Ratatouille|Gem#ue#se-schmoren-Frankreich-kochen-Film
Karotte|Mohrr#ue#be-orange-Hase-Gem#ue#se-Vitamine
Ass|eins-K#oe#nig-Karte-gut-Tennis
Sixpack|Muskeln-Bauch-hart-flach-Mann
Kehle|Hals-Mund-schlucken-schnarchen-hinten
Erbsenz#ae#hler|genau-ordentlich-Pendant-Mensch-Bohne
Himalaya|Berg-hoch-Asien-Everest-Tibet
PSY|Musik-Rap-S#ue#dkorea-Gangnam Style-YouTube
Fingerhut|n#ae#hen-Nadel-Metall-stechen-Pflanze
Riechkolben|Nase-schn#ue#ffeln-gro#ss#-Gesicht-Mais
Kessel|Wasser-kochen-Herd-Tee-sammeln
Klingelton|Handy-Telefon-Signal-Anruf-Musik
Trailer|Film-Kino-ansehen-kurz-Werbung
Nanny|Kind-Aufsicht-Frau-M#ae#dchen-super
Post|Brief-Kasten-schicken-Marke-Karte
Skype|online-telefonieren-sehen-Internet-anrufen
Videotext|Fernsehr-Sender-Seite-Infos-Programm
Handtasche|Geld-B#oe#rse-Frau-tragen-suchen
Erdbeben|Boden-wackeln-Ersch#ue#tterung-Richterskala-Katastrophe
Richtig|falsch-korrekt-bewerten-Frage-gut
Baby|Kind-S#ae#ugling-Mutter-klein-s#ue##ss#
Puls|Herz-Blut-Handgelenk-messen-z#ae#hlen
Teufelsk#ue#che|Satan-H#oe#lle-Huf-essen-kommen
K#oe#der|Wurm-Angel-Haken-fangen-Fisch
Frosch|Reptil-Kr#oe#te-h#ue#pfen-quaken-Wetter
Abmelden|anmelden-logout-verlassen-Konto-klicken
Hackepeter|Fleisch-Mett-esse-roh-Schwein
Manga|Comic-Japan-zeichen-Bild-Anime
Lippenstift|Mund-Gesicht-schminken-rot-malen
Sanduhr|Zeit-messen-rieseln-Glas-umdrehen
Atlantik|Ozean-Meer-Wasser-gro#ss#-Westen-Pazifik
Vollmond|Nacht-Himmel-Sonne-halb-leer
Taxi|Auto-fahren-rufen-Geld-Chauffeur
Kerze|Wachs-Docht-Flamme-Licht-brennen
Bulldozer|Fahrzeug-Raupe-Bagger-Schaufel-bauen
Happy Hour|Arbeit-danach-Abend-Bar-Drink
Puppe|spielen-M#ae#dchen-Baby-Figur-Haus
Roman|Buch-lesen-Papier-Geschichte-Polanski
Los Angeles|Amerika-Kalifonien-Stadt-Hollywood-Stars
Treuepunkte|sammeln-einkaufen-Geld-Bonus-Karte
Halle Berry|Schauspielerin-Amerika-X Men-Oscar-Bond
Taschenhund|Tier-klein-tragen-Frau-Chihuahua
Puzzel|Bild-Teil-legen-passen-Hobby
Eule|Vogel-Nacht-fliegen-Uhu-weise
Salzburg|Stadt-#oe#sterreich-Mozart-Pfeffer-Schloss
Sauna|hei#ss#-schwitzen-Dampf-Winter-Handtuch
Elfmeter|Fu#ss#ball-Tor-Punkt-schie#ss#en-Strafe
Sch#ae#len|Haut-abmachen-Banane-Apfel-Orange
Dressing|Salat-So#ss#e-Essig-#oe#l-gie#ss#en
Grand Canyon|Schlucht-Graben-riesen-Arizona-Amerika
Champagner|Sekt-Kohlens#ae#ure-Frankreich-ansto#ss#en-feiern
Einhorn|Pferd-wei#ss#-Kopf-M#ae#rchen-Fantasie
Brownie|Geb#ae#ck-essen-Schokolade-s#ue##ss#-Amerika
Grab|tot-Bestattung-Friedhof-Stein-Sarg
Heiligenschein|Licht-selig-Himmel-Engel-Kopf
Zahnb#ue#rste|Mund-putzen-Pasta-Morgen-Belag
Sumo|Kampf-ringen-Japan-Kreis-Boden
Streiten|Meinung-verschieden-k#ae#mpfen-schreien-diskutieren
Kakerlake|Schabe-K#ue#che-Keller-Boden-Ungeziefer
Mandeln|Hals-Kehle-Operation-Nuss-Marzipan
Fragezeichen|Satz-Ende-Antwort-Ausruf-Punkt
Hafen|Meer-Schiff-anlegen-Becken-Jacht
Huf|Tier-Fu#ss#-Zeh-Pferd-Eisen
Flipper|Automat-spielen-Kugel-Delfin-Flosse
Suchmaschine|Internet-Wort-finden-Treffer-Google-Bing-Yahoo
Kneipe|Bar-trinken-Bier-treffen-Leute
Jo-Jo|Spielzeug-rund-Schnur-hoch-runter
Verkleidung|Kostum-anders-aussehen-Fasching-Karneval
Gleitschirm|fliegen-schweben-Himmel-Wind-fallen
Venus|Planet-Sonne-Erde-Liebe-G#oe#ttin
Recycling|M#ue#ll-trennen-verwerten-neu-Sack
Truthahn|Pute-Gefl#ue#gel-Huhn-essen-f#ue#llen-Thanksgiving
Garage|Auto-parken-abstellen-Tor-Haus
Kontaktlinse|Auge-Brille-sehen-klein-Glas
Barkeeper|Getr#ae#nke-Drink-mixen-Alkohol-Kneipe
Gurke|Gem#ue#se-Salat-gr#ue#n-lang-einlegen
Nervens#ae#ge|Stress-#ae#rgern-anstrengend-Geist-Werkzeug
Zahnstocher|Holz-St#ae#bchen-essen-Rest-piksen
Billard|Tisch-Kugel-Tasche-Loch-Stock
Architekt|Haus-Geb#ae#ude-entwerfen-Pl#ae#ne-zeichen
Artist|K#ue#nstler-K#oe#rper-Zirkus-Akrobat-Drahtseil
Flatscreen|Bildschirm-Fernseher-Monitor-flach-Wand
Coach|Berater-helfen-unterst#ue#tzen-lernen-Experte-Trainer
Model|Frau-M#ae#dchen-sch#oe#n-Schow-Foto
Pose|Haltung-Fotograf-Model-stehen-aussehen
Medizinmann|Schamane-krank-gesund-heilen-Gesang
Schmuggler|Zoll-Grenze-verstecken-Gesetz-Drogen
Mausefalle|zuschnappen-klein-fangen-Keller-K#ae#se
Oktoberfest|M#ue#nchen-Bayern-Wiesn-Bier-Zelt
Whirlpool|Wasser-Bad-entspannen-Blasen-Wellness
Tequilla|trinken-Alkohol-Zitrone-Salz-Mexiko
Bauchtasche|G#ue#rtel-Taille-tragen-Geld-Tourist
Feuerwehr|brennen-Flammen-Auto-Wasser-l#oe#schen
Korken|Flasche-Verschluss-schwimmen-leicht-ziehen
Motor|Auto-Antrieb-Maschine-Verbrennung-Energie
Tatort|Verbrechen-Geschehen-Polizei-absperren-Fernsehen
Knie|Bein-Mitte-Gelenk-beugen-hocken
Null|Zahl-0-nichts-eins-Wert
Friseur|Haare-Schere-schneiden-f#ae#rben-f#oe#nen
Netzhaut|Auge-sehen-Linse-Schicht-Spinne
Wimpern|Auge-Haar-Schutz-Lid-Tusche
H#ue#tte|Haus-klein-Holz-Garten-Hund
Men#ue#|essen-Gang-Restaurant-Computer-anklicken
Croutons|Brot-W#ue#rfel-r#oe#sten-Salat-Suppe
Pinzette|greifen-nehmen-Klammer-klein-ziehen
Katzensprung|Tier-Krallen-Miau
Tabasco|Sauce-scharf-essen-w#ue#rzen-Chili
Staub|Schmutz-Dreck-saugen-fein-Wedel
Display|Schirm-Monitor-anzeigen-Bild-sehen
Veranda|Haus-Terrasse-drau#ss#en-Dach-sitzen-Balkon
Opa|Oma-Vater-gro#ss#-Enkel-alt
Geizkragen|Geld-geben-behalten-Hemd-Hals
Basketball|Sport-spielen-Korb-werfen-Mannschaft
G#ae#nsehaut|Angst-kalt-frieren-R#ue#cken-Ente
|
Surround-Sound|Ton-Kino-Fernsehr-herum-5.1
Socken|Fu#ss#-Strumpf-Schuh-warm-laufen
Krautsalat|essen-Kohl-wei#ss#-Essig-#oe#l-Vorspeise
Backpfeife|Ohr-Wange-schlagen-hauen-trillern
Umarmung|halten-Arme-dr#ue#cken-K#oe#rper
Lasagne|essen-Pasta-Nudeln-Schicht-Italien
Sodbrennen|Magen-S#ae#ure-Bauch-essen-hoch
Hangover|Kino-Film-Bradley Cooper-besoffen-vergessen
Briegmarke|Karte-Paket-Umschlag-Wert-Porto
Doppelkinn|Kopf-Mund-Hals-zwei-dick
Wlan|Netz-Verbindung-Computer-Internet-schnurlos
Gipfeltreffen|Berg-oben-Politik-wichtig-zusammen
Niesen|Nase-Schnupfen-Gesundheit-Hatschi
Kopfschmerzen|wehtut-H#ae#mmern-Schl#ae#fen-Migr#ae#ne-Apsirin
Teilzeit|Job-Arbeit-Woche-Stunde-voll
Akupunktur|Medizin-Nadeln-China-stechen-Schmerz
Pink|Farbe-rosa-rot-M#ae#dchen-S#ae#ngerin
Flatrate|Vertrag-pauschal-Tarif-Internet-Telefon
Floss|Wasser-Fluss-Holz-Boot-schwimmen
Schneemann|Winter-Eis-bauen-Kugel-Mohrr#ue#be
Stinktier|Geruch-Streifen-schwarz-wei#ss#-Pelz
Langeweile|Zeit-machen-g#ae#hnen-egal-nichts
Axt|hacken-schlagen-Holz-scharf-schwingen
Hitzefrei|Sommer-Schule-hei#ss#-aus-Haus
Tapete|Wand-Farbe-kleben-Rausfaser-Bild
Kopfgeldj#ae#ger|Person-Mensch-Ziel-suchen-Belohnung
Wecker|Uhr-Alarm-Morgen-Zeit-stellen
Mondfinsternis|Nacht-Erde-Schatten-Sonne-sehen
Seife|waschen-Bad-Schaum-sauber-riechen
Adler|Vogel-gro#ss#-rauben-Schnabel-Fl#ue#gel
Husky|Hund-Schlitten-Fell-Schnell-kalt
Haare|Kopf-Frisur-Farbe-K#oe#rper-schneiden
#ue#bergewicht|viel-schwer-Waage-Kilo-essen
Kaktus|Pflanze-Wasser-Stacheln-W#ue#ste-spitz
B#ae#uerchen|aufsto#ss#en-r#ue#lpsen-Luft-raus-Baby
Marmelade|s#ue##ss#-Gelee-Obst-Glas-Fr#ue#hst#ue#ck
Vinyl|Scheibe-Musik-Platte-CD-fr#ue#her
Pumpe|Luft-Reifen-Ballon-blasen-treten
Panda|Tier-schwarz-wei#ss#-Zoo-China
Fernsteuerung|Ger#ae#t-Auto-Schalter-fahren-Richtung
R#ae#uberleiter|Dieb-stehlen-Hand-helfen-steigen
Halloween|Oktober-Nacht-Geister-spucken-K#ue#rbis
Souvenier|Erinnerung-Gegenstand-Geschenk-Tourist-mitbringen
Muskelkater|Sport-anstrengend-danach-wehtun-Katze
Auster|Muschel-Schale-Perle-Meer-essen
Kita|Kind-Betreuung-Aufsicht-Job-Garten
Teenager|jung-zehn-Kind-Pubert#ae#t-Hormone
Horrorfilm|Kino-Fernsehr-gruseln-Angst-Nacht
Waxing|Haare-rei#ss#en-Beine-Streifen-glatt
Minijob|Arbeit-gering-Lohn-wenig-Euro
Geruch|Duft-Parf#ue#m-Aroma-Nase-schn#ue#ffeln
X-Factor|Fernsehen-Serie-Mystery-unfassbar-Castingshow
Wellness|Freizeit-entspannen-verw#oe#hnen-Center-Hotel
Pechvogel|Schwierigkeiten-falsch-Gl#ue#ck-#ae#rger-fliegen
Biber|Tier-Pelz-nagen-Damm-Z#ae#hne
Dampfnudel|essen-Klo#ss#-s#ue##ss#-So#ss#e-Rauch-
Metalldetektor|suchen-erkennen-abtasten-Flughafen-Kontrolle
Krawatte|Schlips-Kragen-Hemd-Hals-Mann
Harry Potter|Buch-Film-Rowling-zaubern-Hogwarts
Hypnose|Trance-schlafen-Pendel-unbewusst-sprechen
Heizung|warm-Wohnung-K#oe#rper-Winter-Ofen
Geschichte|erz#ae#hlen-M#ae#rchen-Story-Vergangenheit-fr#ue#her
Bank|sitzen-Stuhl-Park-Konto-Geld
Reisepass|Ausweis-Foto-Urlaub-Stempel-Name
Taggen|spr#ue#hen-Dose-Farbe-Graffiti-Zeichen
Trendsetter|neu-modern-aktuell-zuerst-anders
Sabbern|Speichel-Spucke-Mund-laufen-Baby
Korsett|Kleid-Taille-schn#ue#ren-Frau-eng
EC-Karte|Geld-Bank-Plastik-bezahlen-Kredit
Polizist|Beamter-Staat-Sicherheit-Gesetz-Uniform
#ue#berraschung|pl#oe#tzlich-unerwartet-Geburtstag-Party-Ei
Pudelm#ue#tze|Winter-Kopf-kalt-warm-Hund
Baumwolle|Stoff-Kleidung-wei#ss#-Flocken-Busch
Professor|Universit#ae#t-Lehrer-Wissenschaft-Unterricht-verr#ue#ckt
Fahrrad|Reifen-Lenker-Pedal-Kette-Auto
Techno|Musik-Stil-House-Club-tanzen
Kandierter Apfel|rot-s#ue##ss#-Obst-Jahrmarkt-Kinder
Schnurlos|Kabel-Ger#ae#t-Telefon-Strom-Stecker
Fahrschule|Auto-Schein-Stunde-Verkehr-Pr#ue#fung
Reifenpanne|Auto-Rad-Schlauch-wechseln-platt
Kolhdampf|Hunger-essen-gro#ss#-Magen-knurren
Roter Teppich|Boden-Farben-Premiere-Promis-Stars
Spargel|Gem#ue#se-essen-Stange-Butter-So#ss#e
Kurve|Ecke-rund-Stra#ss#e-Bogen-kriegen
Sandalen|Schuh-Fu#ss#-Sommer-warm-Strumpf
Brot|essen-B#ae#cker-Korn-wei#ss#
Thermalbad|entspannen-schwimmen-Wasser-hei#ss#-Sauna
Affenzahn|Tier-Schimpanse-Mund-bei#ss#en-schnell
Gl#ue#ckskeks|China-essen-danach-aufbrechen-Zettel
Eis|Wasser-frieren-W#ue#rfel-Speise-Sommer
Eselsohr|Buch-Seite-Knick-merken-I ah
Brasilien|Land-Amerika-S#ue#den-Amazonas-Rio
Einfach|Aufgabe-Frage-leicht-schwer-schlicht
Kristallkugel|Zukunft-Vorhersage-sehen-lesen-Nebel
Pilz|Champignon-Pfifferling-sammeln-essen-krank
Ketchup|Tomate-rot-So#ss#e-Pommes-Majo
Hattrick|Sport-Tor-drei-Fu#ss#ball-Eishockey
Riese|gro#ss#-gewaltig-Mensch-M#ae#rchen-Zwerg
B#ue#cherwurm|lesen-Papier-klug-viel-Regen
Rum|Alkohol-Melasse-trinken-Pirat-Buddel
Eintopf|Suppe-essen-kochen-Gem#ue#se-Fleisch
Korb|Tasche-Weide-flechten-tragen-kriegen
Rosine|Weintraube-getrocknet-s#ue##ss#-Sultanine-Korinth
Maskottchen|Gl#ue#ck-Symbol-Figur-Mannschaft-Sport
Galileo|Fernsehen-Doku-Reporter-Aiman Abdallah-Galilei
Zuckerspiegel|Blut-Diabetes-s#ue##ss#-sehen-Salz
Rauch|Feuer-Brand-Qualm-Kamin-Zigarette
Griff|halten-Hand-T#ue#r-Tasche-Koffer
Schach|Spiel-Brett-matt-Bauer-K#oe#nig
Playlist|Musik-Folge-aussuchen-Titel-Lieder
Batterie|Strom-Zelle-Energie-aufladen-Akku
Insel|Land-Meer-umgeben-Wasser-einsam
Pirat|Seer#ae#uber-Beute-Schiff-Karibik-Johnny Depp
Beton|Zement-Wasser-mischen-hart-Haus
Nordic Walking|laufen-gehen-Sport-Stock-Ausdauer
Pool|schwimmen-Wasser-Garten-Sommer-Billard
Fliehen|entkommen-weglaufen-eingesperrt-Gef#ae#ngnis-frei
Wikipedia|Internet-online-Enzyklop#ae#die-Lexikon-frei
Hip-Hop|Musik-Stil-tanzen-Rap-Breakdance
Pasta|Nudeln-Teig-Spaghetti-essen-kochen
Drehwurm|schwindelig-kreiseln-rotieren-Kopf-Regen
Kartenhaus|spielen-Skat-bauen-vorsichtig-einst#ue#rzen
Handschuhe|Finger-Winter-kalt-warm-Wolle
Blechschaden|Auto-Unfall-klein-Beule-verletzt
Surfen|Meer-Brett-Wellen-Segel-Internet
Farbe|Rot-Blau-Gelb-Gr#ue#n-Orange
Webcam|Kamera-beobacten-like-Internet-sehen
Nudelholz|K#ue#che-backen-Teig-rollen-flach
Bushaltestelle|fahren-Verkehr-warten-stehen-Bank
Wespe|Insekt-Stachel-Biene-Streifen-Taille
Nest|Vogel-Eier-br#ue#ten-Baum-bauen
Schuhl#oe#ffel|Fu#ss#-Stiefel-anziehen-Suppe-Gabel
Manik#ue#re|Hand-Finger-Nagel-Feile-Lack
Schmuck|Ring-Kette-tragen-Diamanten-Gold
Nachtclub|Bar-Disco-tanzen-Musik-ausgehen
Deckel|Verschluss-Dose-Topf-oben-passen
Knoten|binden-Schnur-Schleife-ausmachen-ziehen
Krake|Tier-Meer-Arme-Tintenfisch-Oktopus
Schlafm#ue#tze|m#ue#de-Nacht-Bett-Kopf-Haube
Strafzettel|Kn#oe#llchen-parken-fahren-Ordnungsamt-aufschreiben
X-Men|Film-Kino-Comic-Mutant-Wolverine
Matratze|Bett-liegen-schlafen-Kissen-Laken
Trainingsanzug|Sport-Fittness-bequem-Hose-Streifen
Sparschwein|Geld-M#ue#nze-Dose-Buch-Kind
Handschellen|felleln-Schl#ue#ssel-Kette-Polizei-festnehmen
Erde|Welt-Globus-Planet-Boden-Mutter
Klon|DNA-Gene-Aussehen-gleich-Doppelg#ae#nger
Fadenkreuz|Strich-sehen-Ziel-Visier-Fernrohr
Leopard|Katze-gro#ss#-rauben-schnell-Flecken
Cocktail|trinken-Alkohol-mischen-Bar-Schirmchen
Paradies|Eden-Himmel-Urlaub-gl#ue#cklich-Vogel
Smartphone|Handy-Internet-eMail-Touchscreen-Kontakt
Bodygoard|Meer-Wasser-Welle-flach-surfen
Sieb|Netz-Loch-schwenken-gie#ss#en-Ged#ae#chtnis
Pfote|Tier-Fu#ss#-Kralle-Hund-Katze
Nussknacker|Weihnachten-Schale-brechen-Zange-Ballett
Singleb#oe#rse|Partner-suchen-online-Internet-Kontakt
Hallo|Haus-Raum-gro#ss#-Sport-Konzert
Lunge|Brust-Luft-atem-Fl#ue#gel-zwei
Gangsta|Rap-HipHop-Ice T- Amerika
Schmetterling|Insekt-Motte-Fl#ue#gel-Raupe-Kokon
Chefkoch|Restaurant-Essen-zubereiten-Herz-M#ue#tze
Capoeira|Brasilien-Kampf-Tanz-Kunst-Akrobatik
Karriereleiter|Beruf-Job-Erfolg-Stufe-oben
Frankreich|Land-Europa-Paris-Eiffelturm-Baguette
Kaution|Gef#ae#ngnis-Strafe-Geld-Richter-frei
Unh#oe#flich|Verhalten-Manieren-Benehmen-Umgang-schlecht
GPS|Signal-finden-Ort-Navigation-Satellit
Klempner|Beruf-Sprengler-Handwerk-Rohr-Roilette
China|Land-Asien-Peking-Hongkong-Mauer
Ordnungsamt|Polizei-Strafe-Versto#ss#-aufpassen-Uniform
Bauchnabel|K#oe#rper-Baby-Mitte-Schnur-Piercing
Second Hand|kaufen-Laden-gebraucht-Kleidung-alt
Update|Software-Programm-aktualisieren-Version-neu
Zuckerwatte|Jahrmarkt-s#ue##ss#-weich-Faden-wickeln
Rubbellos|Karte-Gl#ue#ck-Feld-kratzen-gewinnen
Cappuccino|kaffee-Milch-Schaum-Tasse-Italien
Pr#ue#fung|Test-Arbeit-Abschluss-lernen-wissen
Zeitung|Nachrichten-Presse-drucken-Papier-lesen
Gesund|krank-K#oe#rper-gut-fit-f#ue#hlen
L#ae#cheln|Mund-Lippen-freuen-fr#oe#hlich-grinsen
Kavier|essen-schwarz-Eier-Fisch-teuer
Genie|Mensch-schlau-klug-Verstand-Wahnsinn
Koala|B#ae#r-Beutel-grau-Eukalyptus-Australien
Piercing|stechen-Schmuck-Ring-Nase-Bauchnabel
Langsam|schnell-Tempo-Geschwindigkeit-wenig-bewegen
Keule|Holz-H#oe#hle-Huhn-Bein-Baseball
Emoticon|Symbol-Zeichen-Stimmung-Smiley-Internet
Bodensee|Wasser-Grenze-Alpen-konstanz-gro#ss#
Knabbern|essen-nagen-Z#ae#hne-klein-Zeug
Dumm|d#ae#mlich-bl#oe#d-Intelligenz-schlau-Brot
Marionette|Puppe-Kind-Theater-spielen-Faden
Kichererbse|H#ue#lsenfrucht-Gem#ue#se-essen-lachen-albern
Einbrecher|R#ae#uber-stehlen-Haus-Nacht-T#ue#r
Katzenauge|Licht-Fahrrad-rot-sehen-schnurren
Sackgasse|Tasche-Beutel-tragen-Weg-Ende
Frieden|Ruhe-Einigkeit-schlie#ss#en-Krieg-Taube
Tr#oe#delmarkt|alt-Sachen-Stand-kaufen-handeln
Bed & Breakfast|Zimmer-Nacht-reisen-Ferien-Hotel
Skat|Karten-spielen-Blatt-Stich-reizen
Rind|Tier-Kuh-Vieh-Milch-Fleisch
Keks|essen-Geb#ae#ck-klein-Weihnachten-Teig
James Bond|007-Argent-Spion-geheim-Daniel Craig
Camouflage|Tarnung-Anzug-erkennen-verstecken-sehen
Klinge|Messer-Schwert-scharf-Metall-Eisen
Kamera|Foto-Film-Objektiv-digital-Bild
Publikum|Zuschauer-Menge-Leute-Theater-Konzert
Kung Fu|China-Kampf-Sport-Shaolin-Bruce Lee
Anspitzer|Stift-Mine-Holz-schreiben-drehen
3D|Form-Raum-K#oe#rper-Film-zwei
Quaken|Frosch-Kr#oe#te-Ger#ae#usch-Kehle-Tier
Strau#ss#|Vogel-Tier-W#ue#ste-fliegen-Blumen
Untertitel|Film-sehen-Text-sagen-lesen
Goldfisch|Aquarium-Teich-Tier-Glas-f#ue#ttern
Magen|Bauch-innen-Organ-essen-verdauen
Fl#ue#stert#ue#te|sprechen-leise-laut.h#oe#ren-Rohr
Kaffee|trinken-hei#ss#-Koffein-Morgen-Tee
Kreis|run-Form-Ring-Kugel-Ecke
Android|System-Software-mobil-Smartphone-Handy
Schnorchel|tauchen-schwimmen-Wasser-atmen-Brille
Durst|trinken-Wasser-trocken-Feuchtigkeit-Hunger
Flitterwochen|Hochzeit-heiraten-Urlaub-fahren-danach
Traum|schlafen-Nacht-Tag-Bild-Symbol
Rudel|Gruppe-Tier-Familie-Wolf-L#oe#we
Makler|Haus-Grundst#ue#ck-Immobilie-kaufen-suchen
Park|Stadt-Garten-Rasen-Baum-Platz
Maultaschen|essen-Suppe-Nudel-Mund-Beutel
Stiefelknecht|Schuh-Fu#ss#-ziehen-Hilfe-Diener
Zebrastreifen|Stra#ss#e-gehen-#ue#berqueren-wei#ss#-Auto
16:9|Format-Fernsehr-TV-Bild-breit-4:3
Stargate|Science Fiction-Fernsehen-Serie-Sternentor-reisen
Wellensittich|Vogel-K#ae#fig-zwitschern-Haustier-Meer
Unsterblich|tot-nicht-Zombie-Horror-Vampier
Packungsbeilage|Aphotheke-Medikament-Tabletten-Zettel-falten
Navi|Auto-System-Karte-Ziel-fahren
Registrieren|anmelden-erkennen-Namen-Account-Daten
Payback|kaufen-Kunde-Laden-Karte-Bonus
Glas|durchsichtig-Scheibe-Fenster-trinken-zerbrechen
M#ae#hne|Haare-lang-viel-L#oe#we-Pferd
Kr#ae#henf#ue##ss#e|Augen-Falten-lachen-Vogel-laufen
Nerd|Typ-Computer-schlau-Brille-Au#ss#enseiter
Form|Art-Aussehen-Gestalt-backen-gie#ss#en
Stammbaum|Ahnen-Familie-Herkunft-Zweig-Pflanze
Pudding|Desert-kochen-Vanille-weich-wackeln
Nachos|Chips-Tortilla-dreieckig-So#ss#e-Kino
Stubenhocker|Zimmer-sitzen-drinnen-rausgehen-langweilig
Handtuch|Bad-nass-Wasser-trocken-Dusche
Shuttle|Weltraum-Space-Luft-Bus-Flughafen
W#ue#stenschiff|Kamel-Dromedar-Sand-Wasser-Boot
Pfeffer|Salz-w#ue#rzen-scharf-schwarz-M#ue#hle
Schokolade|Kakao-Tafel-Riegel-braun-s#ue##ss#
Scheinwerfer|Licht-hell-Auto-sehen-Nacht
Nackt|Kleidung-ohne-K#oe#rper-ausziehen-strippen
Liebe|Gef#eh#l-Herz-m#oe#gen-sch#oe#n-Hass
Venedig|Stadt-Italien-Gondel-Kanal-Wasser-Fluss
Anwalt|Gericht-Rat-Vertreter-Straftat-Gef#ae#ngnis-Gesetz-Buch
Schn#ae#ppchen|kaufen-Preis-billig-teuer-machen
Riesenslalom|Ski-Schnee-fahren-Kurve-Zwerg
Workout|Sport-trainieren-Fitness-Programm-Muskeln
Joghurt|Milch-Sahne-L#oe#ffel-Obst-M#ue#sli
Operation|Arzt-Chirurg-krank-Skalpell-Narbe
Lagerfeuer|Holz-brennen-warm-Camping-Nacht
Scherzkeks|Witz-Spa#ss#-albern-lachen-Pl#ae#tzchen
Walross|Meer-Robbe-Z#ae#hne-Flossen-gro#ss#
Bibliothek|Buch-lesen-leihen-Ausweis-leise
#oe#kostrom|Energie-Umwelt-erneuerbar-Wasser-Wind
Fango|Packung-Schlamm-Heilung-Vulkan-Therapie
1.April|Monat-Tag-Scherz-Witz-reinfallen
Regenwald|Natur-S#ue#damerika-Tropen-Baum-Wasser
Bierbauch|trinken-Pils-Hefe-Wampe-dick
Piano|Klavier-Fl#ue#gel-Musik-Tasten-Instrument
Monster|Ungeheuer-Angst-Horror-h#ae#sslich-Frankenstein
Handball|Sport-spielen-Fu#ss#-Feld-Tor
Blase|Haut-Wasser-Fu#ss#-Pflaster-wund
Kuli|schreiben-Stift-Kugel-Koffer-tragen
Tweet|Twitter-Beitrag-Nachricht-kurz-schnell
Ping Pong|Sport-Tisch-Tennis-Schl#ae#ger-Ball
Zeugnis|Note-Bewertung-Schule-Arbeit-Bewerbung-Ende-Jahr
Gummiente|Wanne-Bad-spielen-quietchen-gelb
Quelle|Fluss-#oe#l-Ursprung-Anfang-Boden
Wasserbett|schlafen-Nacht-liegen-f#ue#llen-fl#ue#ssig
Feuerwerk|Silvester-Rakete-knallen-bunt-anz#ue#nden
Kurssichtig|Brille-Auge-Glas-weit-Ferne
Bl#ue#te|Blume-Knospe-Blatt-bunt-Falschgeld-Pflanze
Finger|Hand-f#ue#nf-Daumen-zeigen-Ring
Gr#ue#nschnabel|Anf#ae#nger-jung-wissen-Farbe-Ente
Eiskaffee|kalt-hei#ss#-Sommer-trinken-Sahne
Fledermaus|Tier-fliegen-Nacht-Vampier-Batman
USB-Stick|speichern-Gigabyte-Medium-anschlie#ss#en-Computer
Bankett|Essen-Fest-G#ae#ste-Tisch-Rede
Samenbank|Baby-Kind-Sperma-Lager-spenden
Geige|Musik-Instrument-Saite-Bogen-spielen
Leinwand|Maler-Bild-#oe#l-Kino-Film
Sonnenschein|Tag-hell-warm-freundlich-Regen
Public Viewing|Fernsehr-Sport-dau#ss#en-zusammen-gucken
Regenbogen|Sonne-Wetter-Farben-Himmel-Schatz
Picknick|essen-drau#ss#en-Korb-Decke-Wiese
Rentier|Hirsch-Geweih-gro#ss#-Karibu-Schlitten-Weihnachten
Jukebox|Automat-M#ue#nze-Musik-Lied-w#ae#hlen
Ice Age|Film-Kino-Eiszeit-Faultier-Manni
Hotdog|Wurst-Brot-essen-Senf-Zwiebeln
Callcenter|Telefon-anrufen-Service-Kunde-Beratung
Bachelor|studieren-Uni-Hochschule-Grad-Abschluss
Geld|Kohle-Knete-Moneten-Zaster-Flocken
Essst#ae#bchen|Holz-zwei-Besteck-China-Reis-Messer-Gabel
Schornstein|Dach-Rauch-Haus-Kamin-Feger
Rock|anziehen-Frau-Hose-Schotten-Musik
Rollmops|Fisch-Hering-sauer-Gurke-Hund
Festnetz|Telefon-zuhause-Handy-Nummer-sprechen-K#oe#rper-Fu#ss#-Bein-Arm-Kopf
E10|Benzin-Bioethanol-tanken-Kraftstoff-Auto
Murmeln|Kugel-spielen-Kinder-fl#ue#stern-leise
Pinguin|Vogel-fliegen-watscheln-schwarz-S#ue#dpol
Tattoo|Bild-Haut-Tinte-stechen-Rose
Spiegel|sehen-Glas-reflektieren-Bad-Wand
Facebook|Internet-sozial-Netzwerk-Freund-anstupsen
Garten|Haus-Rasen-Zaun-Blumen-Baum
Cornflakes|Fr#ue#hst#ue#ck-Flocken-Milch-s#ue##ss#-M#ue#sli
Amazonas|S#ue#damerika-Fluss-Wasser-lang-Becken
Zombie|Monster-gruselig-Film-untot-Geist
Hose|Kleidung-Bein-Jeans-anziehen-Wind
#oe#l|fl#ue#ssig-fett-Erde-Olive-Essig
Kompass|Richtung-Norden-Magnet-Pfeil-verirren
Rose|Blume-Dornen-Liebe-Duft-rot
Astrologie|Sterne-Himmel-Zeichen-Zukunft-deuten
New York|Amerika-Stadt-Manhatten-Hochhaus-Wolkenkratzer
Augenklappe|Gesicht-Kopf-tragen-Pirat-eins
Schreibfeder|Stift-Tinte-F#ue#ller-tauchen-Papier
Ohr|Kopf-h#oe#ren-zwei-Muschel-Ring
Giraffe|Tier-gro#ss#-Afrika-lang-Fleck
R#ue#stung|Ritter-Metall-Schutz-Anzug-Schwert
Kairo|#ae#gypten-Stadt-Nil-W#ue#ste-Pyramiden
Osterei|Fest-Sonntag-suchen-verstecken-Nest
Biene|Insekt-Stachel-Honig-flei#ss#ig-Pollen
Blinddarm|Bauch-lauch-Entz#ue#ndung-Anhang-sehen
Nass|trocken-Wasser-feucht-Regen-Dusche
Dribbeln|Ball-Boden-prellen-Hand-Fu#ss#
Toast|Brot-Schreibe-r#oe#sten-Sandwich-Butter
Seitensprung|Treue-Ehe-Aff#ae#re-Betrug-Liebhaber
Schneidersitz|Boden-Beine-hocken-Yoga-n#ae#hen
Affe|Tier-Mensch-Dschungel-Gorilla-Schimpanse
Dachschaden|Haus-kaputt-reparieren-Kopf-Macke
Trinkgeld|Kellner-Bedienung-bezahlen-Rest-stimmt
Orangenhaut|Cellulite-Schenkel-Po-Dellen-Saft
Kissen|Kopf-weich-Sofa-sitzen-schlafen
Tandem|zwei-Rad-Lenker-fahren-doppelt
Zelt|Camping-Schlafsack-Dach-Plane-Urlaub
Tretm#ue#hle|Fu#ss#-Schritt-Antrieb-Job-Arbeit
B#ue#rgersteig|gehen-Weg-Stra#ss#e-Fu#ss#-Seite
Haken|Angel-Fisch-spitz-K#oe#der-Sache
Datenschutz|Erkl#ae#rung-Person-Angaben-Kind-speichern
Frikadelle|Fleisch-rund-Pfanne-braten-Hamburger
Jonglieren|Ball-Keule-Ring-werfen-fangen
Gespenst|Geist-tot-spuken-Bettlaken-Nacht
Reissz#ae#hne|Tier-Maul-lang-Wolf-Hund
Peitsche|schwingen-schlagen-Leder-Knall-Pferd
Karneval|Fasching-Februar-Kost#ue#m-verkleiden-Rio de Janeiro
Schiedsrichter|Sport-entscheiden-Urteil-Ergebnis-Pfeife
Kanu|Boot-Paddel-Wasser-klein-Kajak
Angsthase|Feigling-Mut-Panik-Ostern-Kaninchen
Drahtseil|Akrobat-Zirkus-Schnur-gehen-Akt
Geistesblitz|Idee-Gedanke-pl#oe#tzlich-Gef#ue#h#oe#-Plan
Tennis|Sport-Platz-Schl#ae#ger-Ball-Wimbledon
Fantasie|Vorstellung-Bild-ausdenken-Geschichte-Realit#ae#t
Treibhaus|Glas-Pflanze-Gem#ue#se-wachsen-Effekt
Milchstra#ss#e|Galaxis-Himmel-Planet-Kuh-Weg
Fechten|Sport-Degen-Schwert-k#ae#mpfen-Duell
Bass|Musik-Instrument-tief-Mann-Stimme
Vitamin C|gesund-Obst-Orange-A-B
Gasse|Stra#ss#e-Weg-schmal-eng-gehen
Sherlok Holmes|Detektiv-Verbrechen-England-Watson-Robert Doeney Jr.
Gerichtsmedizin|Verbrechen-Mord-untersuchen-Spur-Arzt
Musikantenknochen|Arm-Ellenbogen-Nerv-ansto#ss#en-Instrument
Pf#ue#tze|Regen-Bogen-Wasser-sammeln-Schlamm
Telenovela|Serie-Fernsehen-gucken-Roman-S#ue#damerika
Stoppeln|Bart-Haare-Gesicht-rasieren-kratzen
Liegestuhl|Sonne-Sommer-drau#ss#en-Pool-sitzen
Nikolaus|Dezember-Weihnachten-Mann-Sack-Stiefel
Lila|Farbe-blau-rot-violette-Lavendel
Schuppen|Haare-Kopf-Haut-wei#ss#-Fisch
Ebay|Internet-kaufen-versteigern-bieten-Auktion
Stepptanz|Schuhe-Schritt-Musik-Metall-Gene Kelly
Saubohne|Gem#ue#se-gr#ue#n-Erbse-Schwein-grunzen
Honig|Biene-Imker-s#ue##ss#-fl#ue#ssig-klebrig
H#oe#lle|Teufel-Feuer-tot-b#oe#se-Himmel
Spam|eMail-Werbung-Nachricht-Ordner-l#oe#schen
Fan|bewundenr-schw#ae#rmen-Anh#ae#nger-toll-Star
Gep#ae#ck|Koffer-Kleidung-Tasche-schwer-Urlaub
Astronaut|Weltall-Raumschiff-Mond-Anzug-Neil Armstrong
Schwitzen|Haut-hei#ss#-Wasser-Dr#ue#se-Sauna
Schwarzfahrer|Karte-Bus-bezahlen-erwischen-wei#ss#
Ged#ae#chtnis|erinnern-Gedanken-speichern-Kopf-Gehirn
Castingshow|Fernsehen-Talent-singen-Jury-Star
Geheim|kennen-Nummer-Agent-verstecken
Rauswerfer|Disco-Club-Mann-stark-schmei#ss#en
Million#ae#r|Geld-viel-reich-Lotto-Yacht
Couch|Sofa-M#oe#bel-sitzen-Wohnzimmer-Psychiater
Lotterie|spielen-Zahlen-Gl#ue#ck-ziehen-Gewinn
Curry|essen-Gew#ue#rz-Indien-Asien-gelb
Fahren|Auto-Rad-Stra#ss#e-Motor-laufen
Schauspieler|Thater-Film-B#ue#hne-darstellen-Rolle
Konfetti|Papuer-Schnipsel-klein-bunt-werfen
Zehenspitzen|Fu#ss#-vorne-laufen-schleichen-Finger
Intelligent|Verstand-klug-schlau-Quotient-dumm
Windbeutel|Geb#ae#ck-essen-s#ue##ss#-Sahne-gef#ue#llt
Wiegenlied|Bett-schlafen-Baby-Nacht-singen
Lama|Tier-Kamel-spucken-S#ue#damerika-Buddhismus
Halbzeit|Sport-Spiel-Pause-Mitte-Fu#ss#ball
Di#ae#t|Gewicht-abnehmen-dick-Kalorien-essen
Lehrer|Schule-Unterricht-lernen-Ausbildung-beibringen
Geschenk|Gabe-Geburtstag-Weihnachten-einpacken-w#ue#nsche
Delfin|Meer-Fisch-klug-Tier-Flipper
Bio|Natur-Schule-essen-gesund-#oe#ko
D#oe#ner|Kebab-Fleisch-essen-Brot-T#ue#rkei
Remake|Film-neu-alt-Auflage-modern
Abzug|Pistole-Gewehr-schie#ss#en-Finger-Rauch
Golf|Sport-spielen-Schl#ae#ger-Platz-Auto
Flussbett|Wasser-Bach-Boden-schlafen-Nacht
Steckbrieg|Person-suchen-Beschreibung-Verbrechen-Post
Katamaran|Boot-Schiff-Rumpf-zwei-rudern
Besserwisser|schlau-klug-Verstand-alles-Streber
Trommelfell|Ohr-h#oe#ren-Haut-Schlagzeug-Pelz
Geometrie|Mathe-Schule-Form-Lineal-Winkel
Thriller|Film-Buch-Krimi-spannend-Mystery
DJ|Musik-auflegen-spielen-Club-tanzen
Schatten|Sonne-Licht-hell-dunkel-Schirm
Poker|Spiel-Karten-Einsatz-Hand-Full House-Casino
Azubi|Lehrling-Ausbildung-Betrieb-Schule-Beruf
Leuchtturm|Meer-K#ue#ste-Signal-Schiff-warnen
Keilabsatz|Schuhe-Plateau-hoch-Form-Frau
Orange|Frucht-Obst-rund-Saft-Farbe
Tank|Beh#ae#lter-Wasser-Benzin-Auto-Gas
Osterglocke|Blume-gelb-Narzisse-Fr#ue#hling-Hase
Desktop|Computer-Schreibtisch-Bildschirm-Ordner-ablegen
Australien|Kontinent-Sydney-Aboriginies-Outback-K#ae#nguru
Nagellack|Finger-Hand-bunt-Farbe-rot
Donut|Geb#ae#ck-Ring-Teig-essen-s#ue##ss#
Spielzeug|Kind-Fantasie-Puppe-Eisenbahn-Spa#ss#
Gelee|Marmelade-Glas-Fr#ue#hst#ue#ck-Obst-wackeln
Teddyb#ae#r|Spielzeug-Tier-Stoff-weich-kuscheln
Traumfabrik|Film-Kino-Hollywood-schlafen-Flie#ss#band
Massage|K#oe#rper-Muskeln-Verspannung-lockern-kneten
Event|Veranstaltung-Konzert-Kino-Party-Zuschauer
Oper|Musik-singen-B#ue#hne-Arie-Tenor
Mistelzeweig|Baum-Busch-wei#ss#Weihnachten-Kuss
K#ue#ste|Land-Strand-Rand-Meer-Wasser
Kabel|Strom-lang-Stecker-Fernseher-aufladen
M#ue#tze|Hut-Kopf-Haare-baseball-Strick
N#ae#hmaschine|Nadel-Garn-Pedal-Spule-Kleidung
Hand|Finger-Arm-Gelenk-greifen-Fl#ae#che
Atlas|Welt-Globus-Buch-Karte-Plan
Sport|K#oe#rper-fit-gesund-Training-treiben
Streetart|Kunst-drau#ss#en-Wand-Boden-spr#ue#hen
Demonstration|Protest-dagegen-daf#ue#r-marschieren-Stra#ss#e
Outlet|Laden-Store-kaufen-billig-Rabatt
Br#ue#cke|Fluss-Stra#ss#e-dar#ue#ber-kreuzen-Weg
Modedesigner|Beruf-Kleidung-entwerfen-Laufsteg-Lagerfeld
Naturschutz|Umwelt-aktiv-aufpassen-Zerst#oe#rung-Mensch
Feinstaub|Schmutz-Partikel-Luft-klein-krank
Kontakt|Verbingung-Strom-K#oe#rper-Ber#ue#hrung-Person
Vielflieger|Reise-Meilen-Programm-Rabatt-Punkte
Brandenburger Tor|Berlin-Hauptstadt-Wahrzeichen-Durchfahrt-Quadriga
Haust#ue#r|wohnen-Dach-vorne-#oe#ffnen-klingeln
Maske|Gesicht-verstecken-verkleiden-Karneval-Gas
Werwolf|Monster-Hund-verwandeln-Mensch-Mythos
Bart|Mann-Gesicht-Haare-rasieren-Lippe
Schlafwandler|Nacht-Augen-aufwachen-gehen-Bett
Button|Knopf-Taste-Feld-Anstecker-Nadel
Schmerz|wehtun-Schlag-Sto#ss#-Aua-Herz-fallen
Hagel|Regeln-Eis-Korn-fallen-sch#ue#tten
Flagge|Fahne-Land-flattern-Farben-hissen-Reich
Buchhalter|Steuern-Geld-Akten-Firma-B#ue#ro
Heizpilz|warm-kalt-drau#ss#en-Gas-Champignon
Must-Have|haben-m#ue#ssen-absolut-unbedingt-jeder
Gr#ue#bchen|Mund-Gesicht-Wange-Loch-l#ae#cheln
Schowdown|Film-Ende-Action-Explosion-spannend
Nebensache|Hauptsache-wichtig-egal-Ding-sch#oe#n
Schallmauer|Ton-h#oe#ren-durchbrechen-fliegen-Haus
Metzger|Beruf-Handwerk-Fleisch-Messer-schneiden
Braut|Hochzeit-Trauung-Schleier-wei#ss#-Kleid
Regenschirm|Wetter-nass-Wolke-Sonne-trocken
Tor|T#ue#r-Durchgang-Pforte-Fu#ss#ball-Netz
Pille|Tablette-Apotheke-krank-schlucken-bitter
Fr#ue#hling|Jahr-Zeit-Winter-Sommer-gr#ue#n
Dunkelziffer|hell-Zahl-wissen-Statistik-Menge
Strumpfhose|eng-warm-fein-darunter-Frau
Armleuchter|Kerze-Licht-Lampe-zwei-Trottel
Browser|Internet-Web-surfen-Explorer-Safari
Tagebuch|schreiben-Papier-geheim-Gedanken-Ergebnis
Feder|Vogel-weich-Fl#ue#gel-leicht-springen
Keller|Haus-unten-Treppe-Stockwerk-Boden
Lakritze|schwarz-s#ue##ss#-essen-Gummi-Schnecke
Klaustrophobie|Angst-Panik-Raum-eng-geschlossen
Strand|K#ue#ste-Sand-Meer-Wasser-Urlaub
Regisseur|Film-Theater-Schauspieler-Anweisung-Action
Nachmittag|sp#ae#ter-vorher-Abend-Morgen-Zeit
Rucksack|tragen-Tasche-Schule-Urlaub-Schulter-R#ue#cken
Kaugummi|Mund-Z#ae#hne-Essen-Blase-Pfefferminz
Luftschiff|fliegen-Fahrzeug-Ballon-Werbung-Zeppelin
Explosion|sprengen-Dynamit-fliegen-Luft-Feuer
U-Bahn|Tunnel-Zug-fahren-Verkehr-#oe#ffentlich
Schaltjahr|366-4-29-Februar-Tag
Kreuzfahrt|Urlaub-Schiff-Luxus-Ziel-Karibik
Kater|Katze-Tier-m#ae#nnlich-Kopfweh-Morgen
Hubschrauber|fliegen-Rotor-Motor-drehen-senkrecht
Dicksch#ae#del|stur-Eigensinn-Kopf-d#ue#nn-nachgeben
K#oe#nig|Monarch-Herrscher-Land-Krone-Kaiser
Steinzeit|Geschichte-Epoche-Jahr-H#oe#hle-Mensch
Scharchen|schlafen-Nase-schnaufen-Ger#ae#usch
Patient|Arzt-Doktor-krank-behandeln-pflegen
Mumie|Leiche-K#oe#rper-tot-einbalsamieren-Grab-#ae#gypten
Neugier|Interesse-erfahren-fliegen-fragen-herausfinden-spannend
Festhalten|Hand-Griff-verlieren-fallen-umarmen
K#ae#mmen|Haare-B#ue#rste-ordnen-Finger-Kopf
Kuss|Mund-Lippen-Wange-Liebe-knutschen-Paar
Stress|#ae#rger-Arbeiten-viel-anstrengend-Nerven
Windpocken|krank-Kind-anstecken-Pusteln-Virus
Nadel|n#ae#hen-Faden-stecken-spitzen-Heuhaufen
Rest|#ue#brig-wenig-Ende-Essen-M#ue#ll
Wanderpokal|Troph#ae#e-Preis-gewinnen-laufen-gehen
Ehrlichkeit|Warheit-l#ue#gen-sagen-Vertrauen-aufrichtig
Nagel|Hammer-Wand-schlagen-Finger-Zeh
H#ae#ngematte|Netz-Bett-schlafen-anbinden-Baum
Weinregal|Flasche-Holz-Lager-liegen-sammeln
Cookie|Internet-Website-Daten-speichern-Keks
Pantoffelheld|Mann-Ehe-Frau-Schuh-darunter
Spinne|Netz-acht-Beine-Insekt-krabbeln
Lasso|Seil-Cowboy-werfen-Schlinge-Kuh
Fr#ue#hbucher|Urlaub-Ferien-Hotel-Prozente-Rabatt
S#ae#ule|Geb#ae#ude-St#ue#tze-halten-Decke-Boden
Taucherbrille|Wasser-schwimmen-unten-Schutz-Auge
Extremsport|Freizeit-besonders-Kick-aufregend-ungew#oe#hnlich
Eidechse|Reptil-Tier-klein-hei#ss#-Schwanz
Kugelfisch|Wasser-Tier-Japan-rund-giftig
Paparazzi|Fotograf-Journalist-Presse-heimlich-jagen
Lachen|kichern-Hahaha-Witz-lustig-Spa#ss#
Job|Beruf-Stelle-Geld-arbeiten-Gehalt-Steuern
Neon|Licht-grell-R#oe#hre-Farbe-Element
Note|Musik-spielen-Sch#ue#ssel-Duft-Schule
Birne|Obst-Baum-essen-gl#ue#hen-Kopf
Loch|bohren-L#ue#cke-Nase-Ohr-Ness
Ohrring|Schmuck-Kopf-zwei-Loch-Piercing
Lebkuchen|Geb#ae#ck-essen-Weihnachten-Mann-Haus
Sattel|Pferd-reiten-Fahrrad-sitzen-Leder
Fallschirm|fliegen-springen-Flugzeug-Rei#ss#leine-#oe#ffnen
Slum|Stadt-Viertel-arm-leben-Elend
Gitarre|Musik-Instrument-spielen-Saiten-Bass-stimmen
Schneebesen|Winter-Eis-K#ue#che-r#ue#hren-kehren-backen
Dudelsack|Musik-Instrument-Pfeifen-blasen-Schottland
Boxer|Sport-Kampf-Ring-Handschuhe-Hund
Mais|Feld-Korn-gelb-essen-Kolben
Brillenschlange|Auge-sehen-Glas-Reptil-lang
Inlineskates|Rollschuh-laufen-fahren-Reihe-Blades
Restauranttester|Fernsehen-Reality-Gastst#ae#tte-pr#ue#fen-Michelin
** LOL **|eMail-SMS-Zeichen-lachen-Smiley
Borinsel|#oe#l-Plattform-Meer-See-Sockel
Irrgarten|Labyrinth-Weg-laufen-Ausgang-finden
Fast Food|Hamburger-Cheeseburger-Pommes-D#oe#ner-Bratwurst
K#ae#nguru|Tier-Beutel-springen-Australien-boxen
Globus|Welt-Kugel-rund-drehen-Atlas
Bumerang|werfen-krumm-zur#ue#ck-Luft-Australien
Parf#ue#m|Duft-Geruch-Flakon-spr#ue#hen-gut
Anruf|Telefon-Handy-klingeln-Freund-rangehen
Kalender|Monat-Jahr-Tag-Zeit-Zahl
Tr#ue#ffel|Pilz-schwarz-Schwein-Schokolade-Praline
Trauzeuge|Hochzeit-Braut-Ehe-Ring-zwei
Jeans|Hose-Bein-blau-Stoff
Rassel|Baby-spielen-sch#ue#tteln-Ger#ae#usch-klappern
Kupfer|Ketall-M#ue#nze-rot-Gold-Kessel
Erdm#ae#nnchen|Tier-klein-W#ue#ste-stehen-gucken
Rippen|K#oe#rper-Wirbel-Knochen-Brust-Schutz
Valentinstag|Februar-14-Liebe-Blumen-Karte
Lampenfieber|B#ue#hne-Auftritt-vorher-nerv#oe#s-aufgeregt
Luftkissenboot|F#ae#hre-Wasser-schweben-Propeller-Hovercraft-schlafen-Bett
Pfandhaus|Schmuck-Wert-verleihen-Geld-versetzen
K#ue#hlschrank|K#ue#che-Ger#ae#t-Eis-kalt-Essen
Verstecken|weg-heimlich-Spiel-suchen-finden
Strohhalm|trinken-lang-Glas-Heu-klammern
Streichholz|Feuer-brennen-anz#ue#nden-reiben-Schachtel
Drau#ss#en|drinnen-Natur-Haus-frei-Ausflug
Sch#ue#chtern|scheu-zur#ue#ckhalten-Scham-Angst-verlegen
Mayonnaise|Sauce-Ei-#oe#l-Salat-Ketchup-wei#ss#-Pommes
Hering|Fisch-Meer-Schwarm-Dose-ger#ae#uchert
Quartett|vier-Karten-sammeln-Instrument-Musik
R#ue#ssel|Nase-lang-Elefant-Schwein-saugen
Boxenstopp|Formel 1-Auto-rennen-Reifen-tanken
M#ue#ll|Abfall-Tonne-T#ue#te-wegwerfen-rausbringen
Jacht|Boot-Schiff-Meer-Segel-reich
Forum|Platz-Ort-Internet-treffen-diskutieren
Spion|Agent-geheim-Informationen-verdeckt-James Bond
Glatteis|Winter-frieren-Wasser-rutschen-f#ue#hren
Nickerchen|schlafen-m#ue#de-Mittag-kurz-Sofa
Joggen|laufen-rennen-Sport-fit-Ausdauer
Tennisarm|Sport-Netz-Ball-Schl#ae#ger-wehtun
Ap#ue#theke|Rezept-Arzt-Medikament-Tablette-kaufen
Bluetooth|Funk-#ue#bertragung-Verbindung-Handy-Computer
Talent|Begabung-k#oe#nnen-besonders-zeigen-Show
Kunde|kaufen-Gesch#ae#ft-schoppen-Geld-Klient
Kritiker|Zeitung-Bericht-beurteilen-Film-Buch
Kloster|Nonne-M#oe#nch-Orden-Religion-leben
Taube|Vogel-gurren-Stadt-Frieden-Liebe
Diamant|Stein-Brillant-Schmuck-Ring-hart
Papier|schreiben-Stift-Blatt-wei#ss#-Buch
Polterabend|Hochzeit-Tag-davor-Teller-schmei#ss#en
Pferdeschwanz|Zopf-Haare-lang-Gummi-Frisur
Bach|Wasser-Fluss-klein-pl#ae#tschern-Bl#ue#ten
Gehirnw#ae#sche|denken-Verstand-Kopf-neu-s#ae#ubern
Himmelbett|ohne-Sonne-Wolke-schlafen-Dach
Looping|Schleife-#ue#berschlag-fliegen-Achterbahn-kopf#ue#ber
Waage|Gewicht-Gramm-Kilo-K#ue#che-Sternzeichen
Scanner|Computer-erkennen-Kasse-Piep
Schaumparty|Disco-tanzen-Leute-Kanone-wei#ss#
Slacklining|Seil-Gurt-balancieren-Baum-spannen
Big Bang|Theory-Urknall-Comedy-Sheldon-Leonard
Touchscreen|Computer-Tablet-Finger-Monitor-ber#ue#hren
Anstubsen|Finger-sto#ss#en-klopfen-Freund-Facebook
Saftladen|Gesch#ae#ft-schlecht-bl#oe#d-Orange-trinken
Federbett|Decke-schlafen-warm-kissen-Gans
Rasierapparat|Bart-Kinn-Morgen-brummen
Freiheitsstatue|New York-Amerika-Symbol-Fackel-Insel
Dschungelcamp|Star-holt-mich-hier-raus
Bommel|Wolle-M#ue#tze-baumeln-rund-Kugel
Olympische Ringe|Sport-Spiele-Flagge-Farben-f#ue#nf
Banane|Obst-gelb-krumm-Schale-ausrutschen
Quiz|Frage-Antwort-Spiel-raten-gewinnen
Kummertante|Sorgen-Problem-Brief-Zeitschrift-Telefon
Weisheitszahn|Gebiss-Mund-Arzt-Ziehen
Elfenbein|Elefant-Zahn-wei#ss#-Afrika-K#ue#ste
Hypothek|Haus-Bank-Geld-Raten-abzahlen
Tablet|Computer-PC-klein-ber#ue#hren-Finger
Landkarte|Plan-Stra#ss#e-Ort-Atlas-suchen
Zocken|spielen-Finger-dr#ue#cken-Punkte-Computer
Reality-Show|Fernsehen-Zuschauer-Kamera-Leute-beobachten
APP|Programm-Software-Anwendung-Computer-Store
Seestern|Meer-Wasser-Arme-Tier-Himmel
E-Book|Buch-lesen-Computer-Internet-herunterladen
Eisenbahn|Zug-Lokomotive-fahren-Schienen-reisen
Parkkralle|Auto-Rad-fahren-stehlen-Schutz
Windhund|Tier-bellen-rennen-schnell-wetten
Waschstra#ss#e|Auto-sauber-Anlage-fahren-Weg
Stra#ss#enmusik|Instrument-singen-spielen-Geld-Hut
Wunschbrunnen|Wasser-pl#ae#tschern-M#ue#nze-Erf#ue#llung-glauben
Bundesliga|Sport-Fu#ss#ball-Tabelle-Mannschaft-regional
Gewitter|Donner-Blitz-Regen-Wind
Gedicht|Reim-Vers-Literatur-schreiben-Liebe
Mensa|Kantine-Schule-Universit#ae#t-essen-Cafeteria
Golfstrom|Wetter-Wind-Sport-Auto-Steckdose
Einrad|fahren-zwei-Lenker-Pedal-Balance
Maulesel|Pferd-reiten-Sattel-Kreuzung-Mund
Postkarte|Brief-Urlaub-Ferien-Bild-Marke
Minigolf|Platz-Schl#ae#ger-Loch-klein-spielen
Markt|Stand-kaufen-H#ae#ndler-frisch-schreien-super
Torte|Kuchen-Obst-Schokolade-Sahne-Geburtstag
Doping|Sport-Mittel-verboten-besser-Kontrolle
Avatar|Internet-Person-virtuell-k#ue#nstlich-Film
DSDS|Castring-Show-Fernsehen-singen-Bohlen
Err#oe#ten|Gesicht-Wange-peinlich-sch#ae#men-Aufregung
Gold|Metall-Silber-wertvoll-Ring-Medallie
Blog|Internet-Web-online-schreiben-lesen
Mikrofon|sprechen-singen-laut-aufnehmen-Radio
Lamm|Schaf-jung-klein-Tier-s#ue##ss#
Shoppingkanal|Fernsehen-Sender-Programm-kaufen-QVC
Zitteraal|Fisch-Wasser-Strom-lang-Schlange
Wirbelsturm|Wetter-Wind-Regen-Hurrikan
Ananas|Frucht-Obst-s#ue##ss#-Scheibe-Dose
Presse|Maschine-dr#ue#cken-Zeitung-Reporter-Regenbogen
Huckepack|R#ue#cken-tragen-nehmen-Schultern-Kind
Zitrone|Frucht-Obst-gelb-sauber-Orange
Auktion|Versteigerung-bieten-Betrag-Hammer-Zuschlag
Gift|Stoff-krank-K#oe#rper-sterben-Mord
SMS|Nachricht-Text-Handy-schicken-lesen
Erdbeere|Obst-rot-pfl#ue#cken-Sommer-Sahne
Seetang|Algen-Meer-Wasser-unten-gr#ue#n
Anzug|Hose-Jacke-Kleidung-tragen-Anlass
Wrestling|Catchen-Ring-Kampf-Sport-Show
Kopfh#oe#rer|Musik-Ohr-lauschen-St#oe#psel-Ton
Schnell|rasch-eilig-fahren-Tempo-langsam
Klippe|K#ue#ste-Felsen-steil-abw#ae#rts-klettern
Schwanger|heiraten-Ehe-Familie-verwandt-Bruder
Beamen|Licht-Strahl-Transport-Star Trek-Scotty
Marathon|Sport-laufen-lang-Kilometer-Ausdauer
Herz|K#oe#fper-Blut-Pumpe-Liebe-Schmerz
Hamster|Tier-K#ae#fig-klein-Rad-Gold
V.I.P.|Promi-Star-wichtig-Lounge-Status
Denglisch|Sprache-Deutsch-Englisch-mischen-Wort
Hammerhai|Fisch-Meer-Wasser-Nagel-bei#ss#en
Junk|Mail-Papierkorb-l#oe#schen-Food-Mist
Marshmallow|s#ue##ss#-wei#ss#-weich-Schaum-Amerika-drau#ss#en
Humor|lachen-Witz-komisch-haben-viel
Seifenoper|Fernsehen-Serie-waschen-Wasser-singen
Geisterstadt|Ort-leer-verlassen-Gespenst-gruselig
Samurai|Japan-Krieger-Adel-Schwert-sieben
Knoblauch|Knolle-Zehe-Zwiebel-Gew#ue#rz-Geruch
Handy|Telefon-sprechen-anrufen-mobil-Funk
Signal|Verbindung-Netz-Handy-Rauch-Zeichen
Fee|M#ae#rchen-Fantasie-Zauberstab-Fl#ue#gel-gut
Rabenmutter|Kind-Eltern-Vater-Vogel-Kr#ae#he
Cowboy|Amerika-Westen-Pferd-Hut-Rind
Science Fiction|Zukunft-Film-Weltraum-Fantasie-morgen
B#oe#ller|Feuerwerk-Knall-Kracher-laut-Silvester
Skateboard|Brett-Rollen-fahren-Stra#ss#e-Trick
Samt|Stoff-Material-weich-Kleidung
Newsletter|eMail-Information-Werbung-Website-Neuigkeit
Botox|Gift-Toxin-Haut-Gesicht-spritzen
Flirten|Liebe-Kontakt-sehen-Blick-Spiel
Ciabatta|Brot-Italien-flach-Baguette-essen
Snowboard|Schnee-Winter-Ski-Berg-fahren
Eifersucht|Neid-haben-Gef#ue#hl-Partner-krank
Cham#ae#leon|Tier-Reptil-Tarnung-Haut-Farbe
Ipad|Tablet-Computer-klein-#ue#berall-Apple
Schwammkopf|SpongeBob-Zeichentrick-Fernsehen-Meer-gelb-Lied
Downloaden|Datei-Internet-online-speichern-Computer
Transformers|Film-Kino-verwandeln-Shia LeBeouf-Optimus Prime
B#ue#gel|Kleider-aufh#ae#ngen-Schrank-Eisen-Brille
Weintraube|Obst-essen-Rebe-gr#ue#n-blau
Feierabend|Arbeit-Schluss-Tag-zuhause-Kneipe
Villa|Haus-Anwesen-gro#ss#-reich-wohnen
Radar|Funk-erkennen-orten-Signal-Antenne
Leberwurst|essen-Fleisch-Brot-streichen-grob
Brandit|Dieb-R#ae#uber-Verbrecher-stehlen-#ue#berfallen
Botschaft|Diplomat-Vertreter-Land-Staat-Nachricht
Endzeit|Katastrophe-vorbei-Welt-Anfang-Uhr
W#ue#rfel|Seiten-Augen-Spiel-Form-rollen
Roboter|Mensch-Maschine-intelligent-Metall-arbeiten
Saturn|Planet-Sonne-Weltraum-Gas-Ring
Roulette|Spiel-Casino-setzen-Kugel-Zahl
Pyramide|Bauwerk-#ae#gypten-Grab-Gizeh-spitz
Anden|S#ue#damerika-Gebirge-kette-hoch-besteigen
#oe#lteppich|Wasser-auslaufen-Pest-Salat-Boden
Haut|K#oe#rper-H#ue#lle-d#ue#nn-Organ-Schutz