Festlich|Prunkvoll-Eleganz-Feierlich-Glamour-Jubil#ae#um-Schick-Ausgela#ss#enheit-#UE#ppigkeit
Besinnlich|Nachdenklich-Ruhe-Meditation-Gela#ss#enheit-Achtsamkeit-Ausgeglichenheit-Hektik
Geschenke|Pr#ae#sente-#UE#berraschungen-Freude-Verpackungen-Austausch-Dankbarkeit-Mangel
Familie|Zusammenhalt-Verbundenheit-Geborgenheit-Generationen-Liebe-Streit-Einsamkeit
Lichter|Leuchten-Glanz-Strahlen-Kerzenlicht-Illumination-Dunkelheit-Schatten
Schnee|Winterzauber-K#ae#lte-Schneeflocken-Rodeln-Schneeballschlacht-Tauwetter-Schmelzen
Advent|Erwartung-Vorbereitung-Kerzenanz#ue#nden-Adventskranz-Vorfreude-Ungeduld-Nachl#ae##ss#igkeit
Tradition|Brauchtum-Rituale-#UE#berlieferung-Kultur-Moderne-Wandel-Innovation
Gl#ue#hwein|Hei#ss#-Gew#ue#rze-W#ae#rme-Genu#ss#-Punsch-K#ae#lte-Abstinenz
Pl#ae#tzchen|Selbstgebacken-Naschen-Vielfalt-Weihnachtsb#ae#ckerei-Teig-Kalorienbewu#ss#tsein-Di#ae#t
Tannenbaum|Nadeln-Schm#ue#cken-Duft-Weihnachtsbaumschmuck-Gr#ue#n-K#ue#nstlicher Baum-Baumlos
Kerzen|Flackern-Romantik-Wachs-Lichtschein-Dekoration-Dunkelheit-Gefahr
Christkind|Engelsgleich-Geschenkebringer-Heiligenschein-Kindliche Unschuld-Weihnachtsgeschichte-Teufelsgleich-B#oe#sewicht
Weihnachtsmann|Rundlich-Roter Mantel-Bart-Geschenkesack-Rentierschlitten-Grinch-Weihnachtsmuffel
Weihnachtslieder|Singen-Chor-Melodien-Stimmung-Texte-Stille-Unbekanntheit
Frohe Weihnachten|Gl#ue#ckw#ue#nsche-Festtagsgru#ss#-Besinnliche Feiertage-Fr#oe#hlichkeit-Herzlichkeit-Traurigkeit-Mi#ss#mut
Vorfreude|Erwartung-Ungeduld-Freude-Begeisterung-Sehnsucht-Gleichg#ue#ltigkeit-Desintere#ss#e
Gem#ue#tlichkeit|Behaglichkeit-Entspannung-Kuscheligkeit-W#ae#rme-Geborgenheit-Unbehagen-K#ae#lte
Liebe|Zuneigung-Herzlichkeit-N#ae#he-F#ue#rsorge-Harmonie-Gleichg#ue#ltigkeit-Ha#ss#
Frieden|Harmonie-Ruhe-Verst#ae#ndigung-Entspannung-Eintracht-Konflikt-Krieg
Nikolaus|Stiefel-S#ue##ss#igkeiten-Geschenke-Rute-Heiliger-B#oe#ser Nikolaus-Schimpfen
Weihnachtsmarkt|Buden-Gl#ue#hwein-Leckereien-Handwerk-Karu#ss#ell-Leer-Geschlo#ss#en
Schneeflocken|Eisig-Einzigartig-Zerbrechlich-Winterzauber-Frost-Schmelzen-Tauwetter
Punsch|Hei#ss#-Gew#ue#rze-Fruchtig-Alkohol-Becher-K#ae#lte-Abstinenz
Krippe|Jesuskind-Stall-Figuren-Weihnachtsgeschichte-Stroh-K#ae#lte-Unvollst#ae#ndig
Stern|Funkeln-Leuchten-Himmelsk#oe#rper-Weihnachtsdeko-Navigation-Dunkelheit-Unsichtbar
Engel|Fl#ue#gel-Himmelsbote-Besch#ue#tzer-Unschuld-Frieden-Teufel-B#oe#sewicht
Lebkuchen|Gew#ue#rze-Honig-Verzierung-Knusprig-Duft-Trocken-Unappetitlich
Winter|K#ae#lte-Schnee-Frost-Jahreszeit-Gem#ue#tlichkeit-Hitze-Sommer
Weihnacht#ss#tern|Pflanze-Bl#ue#te-Adventsdekoration-Glanz-Wei#ss#-Vertrocknet-Welk
Stille Nacht|Ruhe-Besinnlichkeit-Kerzenschein-Frieden-Schlaf-L#ae#rm-Hektik
Gottesdienst|Kirche-Andacht-Gebet-Gemeinschaft-Glaube-S#ue#nde-Zweifel
Weihnachtsgans|Festmahl-Braten-Gefl#ue#gel-Tradition-Saftig-Vegetarisch-Fast Food
Kamin|Feuer-W#ae#rme-Behaglichkeit-Gem#ue#tlichkeit-Ru#ss#-K#ae#lte-Rauch
Rentiere|Schlitten-Geweih-Rudolph-Gespann-Weihnachtsmann-W#ue#ste-Flugzeug
Geschenkpapier|Verpackung-Bunte Muster-Schleife-Auspacken-Recycling-Einfarbig-Transparent
Schneemann|Karotten-Schal-M#ue#tze-Frostig-Spa#ss#-Schmelzen-Sandmann
Weihnachtsdekoration|Schmuck-Ornamente-Lichterketten-Girlanden-Christbaumkugeln-Schlicht-Leer
Kekse|Pl#ae#tzchen-Naschen-Au#ss#techen-Backen-Lecker-Verbrannt-Trocken
Adventskalender|T#ue#rchen-#UE#berraschung-Vorfreude-Countdown-Schokolade-Voll-Leer
Heiligabend|Bescherung-Feste#ss#en-Familie-Kerzenschein-Besinnlichkeit-Einsamkeit-Arbeit#ss#tre#ss#
Weihnachtsengel|Fl#ue#gel-Lichtgestalt-Boten-Besinnlichkeit-Hoffnung-Teufel-B#oe#sewicht
Schokolade|S#ue##ss#-Naschen-Genu#ss#-Kakao-Tafel-Bitter-Gesund
Wunschzettel|W#ue#nsche-Schreiben-Geschenkideen-Weihnachtsw#ue#nsche-Erf#ue#llt-Verge#ss#en-Leer
Weihnachtse#ss#en|Festmahl-Braten-Tradition-Gemeinschaft-Schlemmen-Di#ae#t-Fast Food
Harmonie|Eintracht-Ausgeglichenheit-Ruhe-Zusammenklang-Frieden-Konflikt-Disharmonie
R#ae#ucherm#ae#nnchen|Rauch-Duft-Tradition-Holzfigur-Handwerk-Geruchlos-Leer
Weihnachtsferien|Schulferien-Freizeit-Entspannung-Reisen-Besuche-Arbeit#ss#tre#ss#-Alltag
Jahreswechsel|Silvester-Neujahr-Feuerwerk-Party-Vors#ae#tze-Stillstand-Routine
Silvester|Party-Feiern-Countdown-Champagner-Knallen-Ruhe-Einsamkeit
Bescherung|Geschenke-Freude-#UE#berraschungen-Auspacken-Familie-Entt#ae#uschung-Leere
Schlitten|Rodeln-Winterfreude-Geschwindigkeit-Pistenabenteuer-Kufen
Schneefall|Winterlandschaft-Frostig-Schneeflocken-Verschneit-Kalt
Weihnachtskarte|Gr#ue##ss#e-Pers#oe#nliche Nachricht-Weihnachtsmotiv-Freundschaft-Postweg
Lichterkette|Festlich-Beleuchtung-Glanz-Leuchten-Lichterzauber
Kaminfeuer|Gem#ue#tlich-W#ae#rme-Knisternd-Behaglich-Holzscheite
Rentierschlitten|Schlittenfahrt-Geschenkeauslieferung-Rentiere-Weihnachtsmann-Fliegen
Weihnachtsbaumkugeln|Verzierung-Gl#ae#nzend-Ornamente-Bunt-Schmuck
Weihnachtslieder|Besinnlich-Gesang-Tradition-Melodien-Festliche Musik
Weihnacht#ss#ocke|Geschenksocke-F#ue#llung-#UE#berraschungen-H#ae#ngend-Str#ue#mpfe
Gl#oe#ckchen|Klingen-Glockenl#ae#uten-Festlich-Klangvoll-Zierde
Geschenkanh#ae#nger|Personalisiert-Etikett-Namen#ss#child-Befestigen-Schleife
Tannenzweig|Duftend-Dekoration-Nadeln-Frisch-Gr#ue#n
Engelshaar|Zart-Gl#ae#nzend-Engel-Wei#ss#-Haar
Weihnachtsm#ue#tze|Festtagskopfbedeckung-Rot Wei#ss#-Nikolaus-Verkleidung-Winteracce#ss#oire
Lametta|Glitzernd-H#ae#ngend-Dekoration-Schimmernd-Festlich
Weihnachtsmarktstand|Budenzauber-Verkauf#ss#t#ae#nde-Gl#ue#hweinstand-Duft-Markt
Zuckerstange|S#ue##ss#igkeit-Rot Wei#ss#-Geschmack-Bonbon-Festlich
Schneeballschlacht|Wintervergn#ue#gen-Spa#ss#-Schneekugeln-Treffer-K#ae#lte
Weihnacht#ss#timmung|Besinnlich-Kerzenschein-Freude-Gemeinschaft-Festtagszauber
Weihnachtsb#ae#ckerei|Pl#ae#tzchen-Duft-Backen-Au#ss#techformen-Naschen
Geschenkgutschein|Pr#ae#sent-Einl#oe#sen-Auswahl-#UE#berraschung-Wert
Schneeschuhe|Winterwandern-Schneegehen-Spazieren-Schneetrekking-Fortbewegung
Weihnacht#ss#chmuck|Dekorieren-Verzierung-Baumschmuck-Festlich-Ornamente
Weihnachtse#ss#en|Festmahl-Gourmet-Gaumenfreuden-Tradition-Schlemmen
Adventskranz|Kerzen-Vorweihnachtszeit-Dekoration-Advent-Tannenzweige
Leuchtsterne|Funkeln-Himmel-Lichter-Gl#ue#hen-Weihnachtsdekoration
Christbaumspitze|Baumkrone-Verzierung-Gipfel-Festlich-Dekoration
Weihnachtsbastelei|Kreativit#ae#t-DIY-Basteln-Handgemacht-Adventszeit
Weihnachtsparty|Feiern-Zusammenkommen-Freunde-Festlich-Geselligkeit
Rentiergeweih|Geweih-Weihnachtsdekoration-Rudolph-Rentiere-Geweihkopfschmuck
Weihnachtszauber|Magie-Festtagszauber-Verzauberung-Wunder-Mystisch
Wunschbaum|W#ue#nsche-Erf#ue#llung-H#ae#ngende Zettel-Hoffnung-Weihnachtsw#ue#nsche
Geschenkesack|Pr#ae#sente-Geschenke-Santa Claus-Sack-F#ue#llung
Weihnachtszeitung|Festtagsausgabe-Nachrichten-Weihnachtsberichte-Lesestoff-Zeitung
Gl#ue#hweinta#ss#e|Punsch-Hei#ss#getr#ae#nk-Winterw#ae#rme-Genu#ss#-Ta#ss#enw#ae#rmer
Adventslicht|Kerze-Licht-Vorweihnachtszeit-Besinnlich-Stimmung
Sternschnuppe|Wunsch-Himmel-Gl#ue#cksbringer-Nachthimmel-Beobachtung
Weihnachtsbraten|Feste#ss#en-G#ae#nsebraten-Truthahn-Fleischgericht-Hauptgang
Schlittschuhlaufen|Eislaufen-Kufen-Wintervergn#ue#gen-Pirouetten-Eiskunstlauf
Geschenkp#ae#ckchen|Verpackung-Pr#ae#sent-#UE#berraschung-Schleife-Auspacken
Weihnachtsverpackung|Einpacken-Geschenkpapier-Schleifenband-Geschenkverpackung-Dekoration
Rentierfutter|Heu-Futter-Leckerli-Rudolph-Tierverpflegung
Weihnachtsengelchor|Chorgesang-Engel#ss#timmen-Himmelsgesang-Festlicher Gesang-A cappella
Tannenzapfen|Baumzapfen-Naturdeko-Zapfen-Wald-Dekoration
Weihnachtsgeb#ae#ck|Pl#ae#tzchen-Kekse-Lebkuchen-Backwaren-Nascherei
Rentiergewand|Gewand-Kost#ue#m-Verkleidung-Rudolph-Rentieroutfit
Krippenspiel|Weihnachtsauff#ue#hrung-Jesuskind-Darstellung-Theaterst#ue#ck-Krippendarstellung
Weihnachtsparade|Umzug-Festlicher Marsch-Parade-Musik-Festtag#ss#timmung
Weihnachtskranz|T#ue#rschmuck-Adventskranz-Dekoration-Festlich-Tannengr#ue#n
Christstollen|Weihnachtsgeb#ae#ck-Backware-Rosinen-Festtagsbrot-Hefekuchen
Weihnachtstorte|Festtagskuchen-Backware-Sahne-Fr#ue#chte-Geb#ae#ck